{
	"name": "test stage",
	"icon": 7,
	"mark": 7,
	"wall1": 31,
	"wall2": 32,
	"bgmId": 2,

	"health": 9,
	"gravityPower": 0.1,
	"openStage": 8,
	"openStory": -1,
	"openPuppet": -1,

	"map": [
		[
			[1,1,1,1,1,1,1,1,1,1,1,1,1,1,1,1,1,1,1,1,1,1,1,1,1,1,1,1,1,1],
			[1,1,1,1,1,1,1,1,1,1,1,1,0,0,0,0,0,0,0,0,0,0,0,0,0,0,0,0,1,1],
			[1,1,1,1,1,1,1,1,1,1,1,0,3,1,1,1,1,1,0,1,1,0,1,1,0,1,1,0,1,1],
			[1,1,1,1,1,1,1,1,1,1,0,1,1,1,1,1,1,1,0,1,1,0,1,1,0,1,1,0,1,1],
			[1,1,1,1,1,1,1,1,1,0,1,0,0,0,20,1,24,4,1,24,4,1,24,4,1,24,4,1,1,1],
			[1,1,1,1,1,1,1,1,1,0,0,0,0,1,24,4,1,24,4,1,8,4,1,24,4,1,8,1,1,1],
			[1,1,1,1,1,1,1,1,1,1,0,0,0,20,1,8,4,1,8,12,1,24,4,1,8,4,1,1,1,1],
			[1,1,1,1,1,1,1,1,1,0,0,0,1,24,4,1,8,4,1,8,4,1,8,12,1,8,1,1,1,1],
			[1,1,1,1,1,1,1,1,1,0,0,0,20,1,4,24,1,8,4,1,24,20,1,8,4,1,1,1,1,1],
			[1,1,1,1,1,1,1,1,0,0,0,1,24,4,1,24,20,1,24,4,1,24,4,1,8,1,1,1,1,1],
			[1,1,1,1,1,1,1,1,0,0,0,4,1,24,4,1,24,4,1,8,20,1,4,4,1,1,1,0,0,1],
			[1,1,1,1,1,1,1,0,0,0,1,24,4,1,8,12,1,24,20,1,24,4,1,24,0,0,0,0,0,1],
			[1,1,1,1,1,1,1,0,0,0,4,1,8,12,1,24,20,1,24,4,1,24,4,1,1,1,0,0,1,1],
			[1,1,1,1,1,1,0,0,0,1,24,4,1,24,4,1,24,20,1,8,4,1,16,1,1,1,1,1,1,1],
			[1,1,1,1,1,1,0,0,0,4,1,24,4,1,24,20,1,16,4,1,8,20,1,1,1,1,1,1,1,1],
			[1,1,1,1,1,0,0,0,1,24,4,1,24,4,1,16,20,1,8,4,1,16,1,1,1,1,1,1,1,1],
			[1,1,1,1,1,0,0,0,4,1,24,4,1,24,20,1,24,20,1,8,20,1,1,1,1,1,1,1,1,1],
			[1,1,1,1,0,0,0,1,24,4,1,24,4,1,16,20,1,24,4,1,16,1,1,1,1,1,1,1,1,1],
			[1,1,1,1,0,0,0,4,1,8,20,1,16,12,1,24,20,1,16,20,1,1,1,1,1,1,1,1,1,1],
			[1,1,0,0,0,0,1,24,4,1,24,20,1,16,4,1,16,20,1,16,1,1,1,1,1,1,1,1,1,1],
			[1,0,1,0,0,0,4,1,24,20,1,24,20,1,24,20,1,24,20,1,1,1,1,1,1,1,1,1,1,1],
			[1,0,1,1,1,1,1,1,1,0,1,1,0,1,1,0,1,1,0,1,1,1,1,1,1,1,1,1,1,1],
			[1,0,3,1,1,1,1,1,0,1,1,0,1,1,0,1,1,0,1,1,1,1,1,1,1,1,1,1,1,1],
			[1,0,0,0,0,0,0,0,0,0,0,0,0,0,0,0,0,1,1,1,1,1,1,1,1,1,1,1,1,1],
			[1,1,1,1,1,1,1,1,1,1,1,1,1,1,1,1,1,1,1,1,1,1,1,1,1,1,1,1,1,1]
		]
	],

	"player": [
		{"x":11,"y":5,"hp":100}
	],

	"enemy": [

	],

	"item": [
		{"type":"star","x":27,"y":11},
		{"type":"coin","x":26,"y":11},
		{"type":"coin","x":27,"y":10},
		{"type":"coin","x":28,"y":10},
		{"type":"coin","x":28,"y":11},
		{"type":"coin","x":27,"y":12},
		{"type":"coin","x":26,"y":12},
		{"type":"coin","x":4,"y":19}
	]
}