{
	"name": "test stage",
	"icon": 3,
	"mark": 3,
	"wall1": 61,
	"wall2": 62,
	"bgmId": 1,

	"health": 9,
	"gravityPower": 0.1,
	"openStage": 4,
	"openStory": 2,
	"openPuppet": -1,

	"map": [
		[
			[1,1,1,1,1,1,1,1,1,1,1,1,1,1,1,1,1,1,1,1,1,1,1,1,1,1,1,1,1],
			[1,1,1,1,1,1,1,1,1,1,1,1,1,1,1,1,1,1,1,1,1,1,1,0,0,0,0,0,1],
			[1,1,1,1,1,1,1,1,1,1,1,1,1,1,1,1,1,1,1,1,1,1,1,1,0,1,1,0,1],
			[1,1,1,1,1,1,1,1,1,1,1,1,1,1,1,1,1,1,1,1,1,1,0,0,0,0,1,0,1],
			[1,1,1,1,1,1,1,1,1,1,1,1,1,1,1,1,1,1,1,1,1,1,1,1,0,0,1,0,1],
			[1,1,1,1,1,1,1,1,1,1,1,1,1,0,0,0,1,1,1,0,0,0,1,1,0,0,1,0,1],
			[1,1,1,1,1,1,1,1,1,1,1,1,0,0,0,0,1,1,0,0,0,0,1,1,0,0,1,0,1],
			[1,1,1,1,1,1,1,1,1,0,0,0,1,1,0,0,1,0,0,1,1,0,0,0,0,0,1,0,1],
			[1,1,1,1,1,1,1,1,0,0,0,1,0,0,0,1,0,0,0,0,1,0,0,0,0,1,1,0,1],
			[1,1,1,1,1,1,1,0,0,0,0,1,1,0,0,1,0,0,1,1,0,0,1,1,1,1,1,0,1],
			[1,1,1,1,1,1,0,0,1,1,0,0,0,0,1,1,0,0,0,0,1,1,1,1,0,0,1,0,1],
			[1,1,1,1,1,0,0,1,1,1,0,0,0,1,1,1,0,0,0,1,1,1,1,0,1,1,0,1,1],
			[1,1,0,0,0,0,1,0,1,1,1,1,1,1,1,1,1,1,1,1,1,1,0,0,0,0,1,1,1],
			[1,0,0,0,0,1,0,1,0,0,0,0,1,1,1,1,1,1,1,0,0,1,0,1,1,1,1,1,1],
			[1,0,1,1,1,0,0,0,1,1,1,0,1,1,1,1,1,1,0,1,0,0,0,0,0,0,1,1,1],
			[1,0,1,1,1,0,0,1,0,1,1,0,0,1,1,1,1,1,0,1,1,1,1,1,1,1,1,1,1],
			[1,0,1,1,1,0,0,0,1,1,0,1,0,0,1,1,1,1,0,0,0,1,1,1,1,1,1,1,1],
			[1,0,0,1,1,0,0,1,1,1,0,0,1,0,1,1,1,1,1,1,0,0,1,0,0,1,1,1,1],
			[1,1,0,1,1,0,1,1,1,0,1,0,0,1,1,1,1,1,0,1,0,0,1,0,0,1,1,1,1],
			[1,0,1,1,0,1,1,1,1,0,0,1,0,0,1,1,1,0,0,1,0,0,1,0,0,1,1,1,1],
			[1,0,0,0,1,1,1,1,1,1,0,0,1,0,1,1,1,0,0,1,0,0,0,0,0,1,1,1,1],
			[1,1,1,1,1,1,1,1,1,0,1,0,0,1,1,0,1,0,0,1,0,0,0,0,0,1,1,1,1],
			[1,1,1,1,1,1,1,1,1,0,0,0,1,1,0,0,1,0,0,0,0,0,0,0,0,1,1,1,1],
			[1,1,1,1,1,1,1,1,1,1,1,0,0,1,0,0,0,0,0,0,0,0,0,0,0,1,1,1,1],
			[1,1,1,1,0,0,0,0,0,0,0,1,1,1,0,0,0,0,0,0,0,0,0,0,1,1,1,1,1],
			[1,1,1,0,1,1,1,1,1,1,1,1,1,1,0,0,0,0,0,0,0,0,0,1,1,1,1,1,1],
			[1,1,1,0,0,0,0,0,0,0,1,1,1,0,0,0,0,0,0,0,0,0,1,1,1,1,1,1,1],
			[1,1,1,1,1,1,1,1,1,0,1,1,0,0,0,0,0,0,0,0,0,1,1,1,1,1,1,1,1],
			[1,1,0,0,0,0,0,0,0,1,1,1,0,0,0,0,0,0,0,0,1,1,1,1,1,1,1,1,1],
			[1,0,1,1,1,1,1,1,1,1,1,0,1,1,1,1,1,1,1,1,1,1,1,1,1,1,1,1,1],
			[1,0,0,0,0,0,0,0,0,0,0,1,1,1,1,1,1,1,1,1,1,1,1,1,1,1,1,1,1],
			[1,1,1,1,1,1,1,1,1,1,1,1,1,1,1,1,1,1,1,1,1,1,1,1,1,1,1,1,1]
		]
	],

	"player": [
		{"x":12,"y":8,"hp":100}
	],

	"enemy": [

	],

	"item": [
		{"type":"star","x":19,"y":8},
		{"type":"coin","x":9,"y":8},
		{"type":"coin","x":7,"y":10},
		{"type":"coin","x":5,"y":11},
		{"type":"coin","x":4,"y":13},
		{"type":"coin","x":3,"y":12},
		{"type":"coin","x":7,"y":12},
		{"type":"coin","x":8,"y":15},
		{"type":"coin","x":10,"y":17},
		{"type":"coin","x":10,"y":19},
		{"type":"coin","x":11,"y":21},
		{"type":"coin","x":11,"y":23},
		{"type":"coin","x":15,"y":25},
		{"type":"coin","x":17,"y":26},
		{"type":"coin","x":17,"y":23},
		{"type":"coin","x":20,"y":23},
		{"type":"coin","x":22,"y":21},
		{"type":"coin","x":21,"y":25},
		{"type":"coin","x":20,"y":20},
		{"type":"coin","x":25,"y":14},
		{"type":"coin","x":25,"y":10},
		{"type":"coin","x":27,"y":10},
		{"type":"coin","x":27,"y":6},
		{"type":"coin","x":27,"y":2},
		{"type":"coin","x":25,"y":4},
		{"type":"coin","x":24,"y":7},
		{"type":"coin","x":21,"y":8},
		{"type":"coin","x":17,"y":8},
		{"type":"coin","x":14,"y":8},
		{"type":"coin","x":3,"y":25},
		{"type":"coin","x":9,"y":27},
		{"type":"coin","x":1,"y":29},
		{"type":"coin","x":7,"y":24},
		{"type":"coin","x":6,"y":26},
		{"type":"coin","x":5,"y":28},
		{"type":"coin","x":4,"y":30}
	]
}