{
	"name": "test stage",
	"icon": 8,
	"mark": 8,
	"wall1": 31,
	"wall2": 32,
	"bgmId": 2,

	"health": 9,
	"gravityPower": 0.1,
	"openStage": 9,
	"openStory": -1,
	"openPuppet": -1,

	"map": [
		[
			[1,1,1,1,1,1,1,1,1,1,1,1,1,1,1,1,1,1,1,1,1,1,1,1,1,1,1,1,1,1,1,1],
			[1,1,1,1,1,1,1,1,1,1,1,1,1,1,1,1,1,1,1,1,1,1,1,1,1,1,1,1,1,1,1,1],
			[1,1,1,1,1,1,1,1,1,1,1,1,1,1,1,1,0,0,0,0,0,0,0,0,0,0,0,0,0,1,1,1],
			[1,1,1,1,1,1,1,1,1,1,1,1,1,1,1,1,1,0,1,1,1,1,1,1,1,1,1,1,0,1,1,1],
			[1,1,1,1,1,1,1,1,1,1,1,1,1,1,0,1,1,0,20,1,1,1,1,1,1,0,0,0,0,0,1,1],
			[1,1,1,1,1,1,1,1,1,1,1,1,1,1,0,1,1,1,0,1,1,1,1,1,4,1,1,1,1,1,1,1],
			[1,1,1,1,1,1,1,1,1,1,1,1,1,1,20,0,0,12,0,24,0,20,1,1,0,1,1,1,1,1,1,1],
			[1,1,1,1,1,1,1,1,1,1,1,1,1,1,20,1,1,1,0,1,1,0,1,1,0,1,1,1,1,1,1,1],
			[1,1,1,1,1,1,1,1,1,1,20,0,0,0,12,1,1,1,0,1,1,0,16,12,0,3,1,1,1,1,1,1],
			[1,1,1,1,1,1,1,1,1,1,20,1,1,1,1,1,1,1,16,1,1,16,1,1,0,1,1,1,1,1,1,1],
			[1,1,1,1,1,1,1,1,1,1,0,1,0,0,0,0,0,0,1,1,0,1,1,1,8,0,1,1,1,1,1,1],
			[1,1,1,1,1,1,1,1,1,1,0,1,1,0,1,1,1,1,1,0,1,1,1,1,1,0,1,1,1,1,1,1],
			[1,1,1,1,1,1,1,1,1,1,0,1,1,0,20,1,1,1,0,1,1,0,0,0,0,0,0,1,1,1,1,1],
			[1,1,1,1,1,1,1,1,1,1,0,1,1,1,0,1,1,20,1,1,4,1,1,1,1,1,1,1,1,1,1,1],
			[1,1,1,1,1,1,1,1,1,1,20,0,0,12,0,24,0,20,1,1,0,1,1,1,1,1,1,1,1,1,1,1],
			[1,1,1,1,1,1,1,1,1,1,20,1,1,3,0,1,1,0,1,1,0,1,1,1,1,1,1,1,1,1,1,1],
			[1,1,1,1,1,1,20,0,0,0,12,1,1,1,0,1,1,0,16,12,0,1,1,1,1,1,1,1,1,1,1,1],
			[1,1,1,1,1,1,20,1,1,1,1,1,1,1,16,1,1,16,1,1,0,1,1,1,1,1,1,1,1,1,1,1],
			[1,1,1,1,1,1,0,1,0,0,0,0,0,0,1,1,0,1,1,1,8,0,1,1,1,1,1,1,1,1,1,1],
			[1,1,1,1,1,1,0,1,1,0,1,1,1,1,1,0,1,1,1,1,1,0,1,1,1,1,1,1,1,1,1,1],
			[1,1,1,1,1,1,0,1,1,0,20,1,1,1,0,1,1,0,0,0,0,0,0,1,1,1,1,1,1,1,1,1],
			[1,1,1,1,1,1,0,1,1,1,0,1,1,20,1,1,4,1,1,1,1,1,1,1,1,1,1,1,1,1,1,1],
			[1,1,1,1,1,1,20,0,0,12,0,24,0,20,1,1,0,1,1,1,1,1,1,1,1,1,1,1,1,1,1,1],
			[1,1,1,1,1,1,20,1,1,3,0,3,1,0,1,1,0,1,1,1,1,1,1,1,1,1,1,1,1,1,1,1],
			[1,1,20,0,0,0,12,1,1,1,0,1,1,0,1,1,0,1,1,1,1,1,1,1,1,1,1,1,1,1,1,1],
			[1,1,20,1,1,1,1,1,1,1,16,1,1,0,1,1,0,1,1,1,1,1,1,1,1,1,1,1,1,1,1,1],
			[1,1,0,1,1,0,0,0,0,0,1,1,1,0,1,1,8,0,1,1,1,1,1,1,1,1,1,1,1,1,1,1],
			[1,1,0,1,1,1,0,1,1,1,1,1,1,20,1,1,1,0,1,1,1,1,1,1,1,1,1,1,1,1,1,1],
			[1,1,0,1,0,0,0,0,0,0,0,1,2,0,0,0,0,0,0,1,1,1,1,1,1,1,1,1,1,1,1,1],
			[1,1,0,1,1,1,1,1,1,1,1,1,4,1,1,1,1,1,1,1,1,1,1,1,1,1,1,1,1,1,1,1],
			[1,1,24,0,0,0,0,0,0,0,0,0,1,1,1,1,1,1,1,1,1,1,1,1,1,1,1,1,1,1,1,1],
			[1,1,1,1,1,1,1,1,1,1,1,1,1,1,1,1,1,1,1,1,1,1,1,1,1,1,1,1,1,1,1,1]
		]
	],

	"player": [
		{"x":14,"y":28,"hp":100}
	],

	"enemy": [

	],

	"item": [
		{"type":"coin","x":17,"y":20},
		{"type":"coin","x":21,"y":12},
		{"type":"coin","x":25,"y":4},
		{"type":"coin","x":29,"y":4},
		{"type":"coin","x":26,"y":12},
		{"type":"coin","x":22,"y":20},
		{"type":"coin","x":18,"y":28},
		{"type":"coin","x":17,"y":10},
		{"type":"coin","x":13,"y":18},
		{"type":"coin","x":9,"y":26},
		{"type":"coin","x":5,"y":26},
		{"type":"coin","x":8,"y":18},
		{"type":"coin","x":12,"y":10},
		{"type":"coin","x":21,"y":20},
		{"type":"coin","x":25,"y":12},
		{"type":"coin","x":28,"y":4},
		{"type":"coin","x":13,"y":10},
		{"type":"coin","x":9,"y":18},
		{"type":"coin","x":6,"y":26},
		{"type":"coin","x":5,"y":28},
		{"type":"coin","x":4,"y":28},
		{"type":"star","x":10,"y":28},
		{"type":"coin","x":16,"y":25},
		{"type":"coin","x":16,"y":22},
		{"type":"coin","x":20,"y":17},
		{"type":"coin","x":20,"y":14},
		{"type":"coin","x":24,"y":9},
		{"type":"coin","x":24,"y":6},
		{"type":"coin","x":18,"y":5},
		{"type":"coin","x":18,"y":8},
		{"type":"coin","x":14,"y":13},
		{"type":"coin","x":14,"y":16},
		{"type":"coin","x":10,"y":21},
		{"type":"coin","x":10,"y":24},
		{"type":"coin","x":28,"y":2},
		{"type":"coin","x":17,"y":2}
	]
}