{
	"name": "test stage",
	"icon": 17,
	"mark": 17,
	"wall1": 21,
	"wall2": 22,
	"bgmId": 3,

	"health": 9,
	"gravityPower": 0.1,
	"openStage": 18,
	"openStory": -1,
	"openPuppet": -1,

	"map": [
		[
			[1,1,1,1,1,1,1,1,1,1,1,1,1,1,1,1,1,1,1,1,1,1,1,1,1,1,1,1,1,1],
			[1,1,1,1,1,1,0,0,1,1,1,1,1,1,1,1,1,1,1,1,1,1,1,1,1,1,1,1,1,1],
			[1,1,1,1,1,1,1,1,1,0,1,1,1,1,1,1,1,1,1,1,1,1,1,1,1,1,1,1,1,1],
			[1,1,1,1,1,0,1,1,1,1,0,1,1,1,1,1,1,1,1,1,1,1,1,1,1,1,1,0,0,1],
			[1,1,1,1,0,1,1,1,1,1,1,1,1,1,1,1,1,1,1,1,0,0,0,0,1,1,0,1,1,1],
			[1,1,1,1,0,0,0,0,0,0,1,1,0,1,1,1,1,1,1,0,1,1,1,1,1,1,0,1,1,1],
			[1,1,1,0,1,1,1,0,0,1,1,1,1,0,1,1,1,1,0,0,0,1,0,0,0,0,0,1,1,1],
			[1,1,0,0,1,1,1,0,0,0,1,1,1,1,1,1,0,0,1,1,1,0,0,0,1,1,0,1,1,1],
			[1,1,1,1,0,1,0,0,0,0,1,1,0,0,0,1,0,0,0,0,0,1,1,1,0,1,0,1,1,1],
			[1,1,1,1,1,1,0,1,1,0,1,0,1,1,0,1,0,0,1,1,1,1,0,1,1,0,0,1,1,1],
			[1,0,1,1,1,0,1,1,1,0,1,1,1,1,0,0,1,0,0,1,1,0,1,1,1,1,1,1,1,1],
			[1,1,0,0,1,0,1,0,1,0,1,1,1,0,1,0,0,0,1,0,1,0,1,1,1,0,1,1,1,1],
			[1,1,1,1,1,0,0,0,0,0,0,0,1,0,2,0,0,0,0,1,0,1,1,0,0,0,0,1,1,1],
			[1,1,1,1,1,2,0,0,0,1,1,1,0,0,0,0,0,0,1,0,1,0,0,0,1,1,0,0,1,1],
			[1,1,1,1,1,1,0,1,1,0,0,1,0,0,0,0,0,2,0,0,0,1,0,1,1,0,1,0,1,1],
			[1,1,1,1,1,0,0,1,1,0,0,1,0,0,0,1,0,1,0,1,1,1,1,1,1,1,1,0,1,1],
			[1,1,1,1,1,0,0,0,0,0,0,0,0,0,0,0,0,1,0,0,0,0,1,1,1,1,1,1,1,1],
			[1,1,1,1,1,0,0,0,1,0,1,0,0,0,0,0,0,0,0,0,0,1,0,0,1,1,1,0,1,1],
			[1,1,1,1,1,0,0,1,0,0,0,0,0,0,1,0,0,0,0,0,0,1,1,1,1,0,0,0,1,1],
			[1,1,1,1,1,1,0,1,0,0,0,1,0,1,0,0,0,0,1,1,0,0,1,1,0,0,0,0,1,1],
			[1,1,1,1,1,1,1,0,1,0,0,1,1,0,0,1,0,1,0,0,0,0,0,0,0,1,1,1,1,1],
			[1,1,1,1,1,0,1,1,0,0,0,1,1,1,1,0,0,1,0,0,2,0,0,1,0,0,1,1,1,1],
			[1,1,1,1,1,1,0,0,0,1,0,0,1,0,0,0,0,0,0,1,0,0,0,1,1,0,1,1,1,1],
			[1,1,1,1,1,0,0,0,0,0,0,0,0,1,0,1,0,0,0,0,0,1,0,0,0,0,0,1,1,1],
			[1,1,1,0,1,1,1,1,0,2,1,0,0,0,0,0,0,1,0,0,0,1,0,0,0,0,0,1,1,1],
			[1,1,1,0,1,1,1,0,0,0,0,1,0,0,0,1,0,1,0,0,0,0,0,0,1,0,0,1,1,1],
			[1,1,1,1,1,0,0,1,1,1,1,1,1,0,0,0,0,0,0,0,1,0,0,0,0,0,0,1,1,1],
			[1,0,1,0,0,1,0,0,0,1,1,1,1,0,1,0,0,1,0,0,0,0,1,1,0,1,1,1,1,1],
			[1,0,1,1,1,1,1,0,1,1,1,1,1,1,1,1,0,0,2,1,1,1,0,1,1,1,1,1,1,1],
			[1,0,1,0,0,1,1,1,1,1,1,1,0,1,1,1,1,0,1,1,1,1,1,1,1,1,1,1,1,1],
			[1,1,1,1,1,1,1,1,1,1,1,1,1,1,1,0,1,1,1,1,1,1,1,1,1,1,1,1,1,1],
			[1,1,1,1,1,1,1,1,1,1,1,1,1,1,1,1,1,1,1,1,1,1,1,1,1,1,1,1,1,1]
		]
	],

	"player": [
		{"x":13,"y":17,"hp":100},
		{"x":15,"y":18,"hp":100}
	],

	"enemy": [
		{"kind":"koro","x":6,"y":16},
		{"kind":"koro","x":19,"y":6},
		{"kind":"koro","x":25,"y":19},
		{"kind":"bone","x":12,"y":16},
		{"kind":"bone","x":18,"y":23},
		{"kind":"armo","x":17,"y":18}
	],

	"item": [
		{"type":"star","x":2,"y":7},
		{"type":"star","x":28,"y":3},
		{"type":"star","x":3,"y":27},
		{"type":"coin","x":23,"y":24},
		{"type":"coin","x":22,"y":25},
		{"type":"coin","x":22,"y":24},
		{"type":"coin","x":23,"y":23},
		{"type":"coin","x":24,"y":23},
		{"type":"coin","x":24,"y":24},
		{"type":"coin","x":23,"y":25},
		{"type":"coin","x":5,"y":5},
		{"type":"coin","x":7,"y":7},
		{"type":"coin","x":9,"y":9},
		{"type":"coin","x":7,"y":12},
		{"type":"coin","x":6,"y":26},
		{"type":"coin","x":7,"y":27},
		{"type":"coin","x":7,"y":23},
		{"type":"coin","x":9,"y":18},
		{"type":"coin","x":26,"y":13},
		{"type":"coin","x":26,"y":6},
		{"type":"coin","x":17,"y":8},
		{"type":"coin","x":18,"y":25},
		{"type":"coin","x":16,"y":26},
		{"type":"coin","x":16,"y":22},
		{"type":"coin","x":19,"y":17},
		{"type":"coin","x":16,"y":16},
		{"type":"coin","x":16,"y":12},
		{"type":"coin","x":12,"y":25},
		{"type":"coin","x":21,"y":11}
	]
}