{
	"name": "test stage",
	"icon": 10,
	"mark": 10,
	"wall1": 21,
	"wall2": 22,
	"bgmId": 3,

	"health": 9,
	"gravityPower": 0.1,
	"openStage": 11,
	"openStory": -1,
	"openPuppet": -1,

	"map": [
		[
			[1,1,1,1,1,1,1,1,1,1,1,1,1,1,1,1,1,1,1,1,1,1,1,1,1,1,1,1,1,1],
			[1,1,1,1,1,1,1,0,0,1,1,1,1,1,1,1,1,1,1,1,1,1,1,1,1,1,1,1,1,1],
			[1,1,1,1,1,1,0,1,0,0,1,1,1,1,1,1,1,1,1,1,1,1,1,1,1,1,1,1,1,1],
			[1,1,1,1,1,1,0,1,1,0,0,0,1,0,1,1,1,1,1,1,1,1,1,1,1,1,1,1,1,1],
			[1,1,1,1,0,0,1,1,1,1,1,0,1,0,1,1,1,1,1,1,1,1,1,1,1,1,1,1,1,1],
			[1,1,1,0,1,1,1,0,1,0,1,0,0,0,1,1,1,1,1,1,1,1,1,1,1,1,1,1,1,1],
			[1,1,1,0,1,0,1,0,1,0,0,0,0,0,1,1,1,1,1,1,1,1,1,1,1,1,1,1,1,1],
			[1,1,1,0,1,0,0,0,1,0,0,1,1,1,1,1,1,1,1,1,1,1,1,1,1,1,1,1,1,1],
			[1,0,1,0,0,0,0,0,1,0,0,0,1,1,1,1,1,1,1,1,1,0,0,0,0,0,0,1,1,1],
			[1,0,0,0,0,0,1,0,1,1,1,0,0,1,1,1,1,1,1,0,0,1,1,1,1,1,0,1,0,1],
			[1,0,0,0,1,0,1,1,1,1,0,0,0,1,1,1,1,1,0,0,0,1,1,1,1,1,0,0,1,1],
			[1,0,1,0,1,0,1,1,1,1,0,0,1,1,1,1,1,1,0,0,1,1,1,0,1,1,0,1,1,1],
			[1,0,1,1,1,0,1,1,1,1,1,0,1,1,1,1,1,0,1,1,1,1,0,1,1,0,1,1,1,1],
			[1,1,1,1,0,1,1,1,1,1,1,0,0,1,1,0,0,1,1,0,0,0,0,0,0,0,0,1,1,1],
			[1,1,1,0,1,1,1,1,1,1,1,0,0,1,0,0,1,1,1,1,0,1,1,0,1,1,1,1,1,1],
			[1,1,0,1,1,1,1,1,1,1,1,1,1,1,1,1,1,1,1,0,1,1,1,1,1,1,1,1,1,1],
			[1,0,1,0,0,1,1,1,1,1,1,1,0,1,1,1,1,1,0,1,0,0,0,1,1,1,1,1,1,1],
			[1,0,0,1,0,1,1,1,1,1,1,0,0,1,1,1,1,1,0,0,0,0,0,1,1,1,1,1,1,1],
			[1,1,1,0,1,0,0,1,1,1,1,0,1,1,1,1,1,1,1,0,0,0,1,1,1,1,1,1,1,1],
			[1,1,1,0,0,1,0,1,1,1,0,0,1,1,0,0,1,1,1,1,1,0,1,0,0,0,0,0,0,1],
			[1,1,1,1,1,0,1,0,0,0,0,0,0,0,1,0,1,1,1,1,1,0,0,1,1,1,1,1,1,1],
			[1,1,1,1,1,0,0,1,1,1,1,1,1,1,0,1,0,0,1,1,1,1,0,0,0,0,0,0,1,1],
			[1,1,1,1,1,1,1,1,1,1,1,1,1,1,0,0,1,0,1,1,1,1,1,1,1,0,1,1,1,1],
			[1,1,1,1,1,1,1,1,1,1,1,1,1,1,1,1,0,1,0,0,1,0,0,0,0,0,0,1,1,1],
			[1,1,1,1,1,1,1,1,1,1,1,1,1,1,1,1,0,0,1,0,1,1,0,1,1,1,1,1,1,1],
			[1,1,1,1,1,1,1,1,1,1,1,1,1,1,1,1,1,1,0,1,0,0,0,0,0,0,1,1,1,1],
			[1,1,1,1,1,1,1,1,1,1,1,1,1,1,1,1,0,0,1,1,1,1,1,0,1,1,1,1,1,1],
			[1,1,1,1,1,1,1,1,1,1,1,1,1,1,1,1,0,0,0,0,0,0,0,0,0,1,1,1,1,1],
			[1,1,1,1,1,1,1,1,1,1,1,1,1,1,1,1,1,1,1,1,1,1,1,1,1,1,1,1,1,1]
		]
	],

	"player": [
		{"x":12,"y":16,"hp":100}
	],

	"enemy": [

	],

	"item": [
		{"type":"star","x":12,"y":14},
		{"type":"star","x":14,"y":14},
		{"type":"coin","x":8,"y":20},
		{"type":"coin","x":12,"y":20},
		{"type":"coin","x":5,"y":21},
		{"type":"coin","x":6,"y":18},
		{"type":"coin","x":3,"y":19},
		{"type":"coin","x":4,"y":16},
		{"type":"coin","x":15,"y":19},
		{"type":"coin","x":14,"y":22},
		{"type":"coin","x":17,"y":21},
		{"type":"coin","x":16,"y":24},
		{"type":"coin","x":19,"y":23},
		{"type":"coin","x":1,"y":17},
		{"type":"coin","x":5,"y":12},
		{"type":"coin","x":1,"y":12},
		{"type":"coin","x":3,"y":11},
		{"type":"coin","x":7,"y":9},
		{"type":"coin","x":7,"y":5},
		{"type":"coin","x":5,"y":6},
		{"type":"coin","x":1,"y":8},
		{"type":"coin","x":24,"y":27},
		{"type":"coin","x":25,"y":25},
		{"type":"coin","x":26,"y":23},
		{"type":"coin","x":27,"y":21},
		{"type":"coin","x":28,"y":19},
		{"type":"coin","x":20,"y":25},
		{"type":"coin","x":21,"y":23},
		{"type":"coin","x":21,"y":17},
		{"type":"coin","x":20,"y":17},
		{"type":"coin","x":23,"y":11},
		{"type":"coin","x":26,"y":13},
		{"type":"coin","x":28,"y":9},
		{"type":"coin","x":19,"y":13},
		{"type":"coin","x":13,"y":3},
		{"type":"coin","x":9,"y":5},
		{"type":"coin","x":7,"y":1},
		{"type":"coin","x":9,"y":8},
		{"type":"coin","x":13,"y":6},
		{"type":"coin","x":11,"y":10},
		{"type":"coin","x":19,"y":10}
	]
}