{
	"name": "test stage",
	"icon": 11,
	"mark": 11,
	"wall1": 21,
	"wall2": 22,
	"bgmId": 3,

	"health": 9,
	"gravityPower": 0.1,
	"openStage": 12,
	"openStory": -1,
	"openPuppet": -1,

	"map": [
		[
			[1,1,1,1,1,1,1,1,1,1,1,1,1,1,1,1,1,1,1,1,1,1,1,1,1,1],
			[1,1,1,1,1,1,1,1,1,1,1,1,1,1,1,1,1,1,1,1,1,1,1,0,0,1],
			[1,1,1,1,1,1,1,1,1,1,1,1,1,1,1,1,1,1,1,1,1,1,0,0,0,1],
			[1,1,1,1,1,1,1,1,1,1,1,1,1,1,1,1,1,1,1,1,1,1,0,0,1,1],
			[1,1,1,1,1,1,1,1,1,1,1,1,1,1,1,1,1,1,1,1,1,1,1,0,1,1],
			[1,1,1,1,1,1,1,1,1,1,1,1,1,1,1,1,1,1,1,1,1,1,3,0,0,1],
			[1,1,1,1,1,1,1,1,1,1,1,1,1,1,1,1,1,1,1,1,1,1,0,0,0,1],
			[1,1,1,1,1,1,1,1,1,1,1,1,1,1,1,1,1,1,1,1,1,1,0,0,0,1],
			[1,1,1,1,1,1,1,1,1,1,1,1,1,1,1,1,1,1,1,1,1,1,0,0,1,1],
			[1,1,1,1,1,1,1,1,1,1,1,1,1,1,1,1,1,1,1,1,1,1,1,0,1,1],
			[1,1,1,1,1,1,1,1,1,1,1,1,1,1,1,1,1,1,1,1,1,1,1,0,0,3],
			[1,1,1,1,1,1,1,1,1,1,1,1,1,1,1,1,1,1,1,1,1,1,0,0,0,1],
			[1,1,1,1,1,1,1,1,1,1,1,1,1,1,1,1,1,1,1,1,1,1,0,1,1,1],
			[1,1,1,1,1,1,1,1,1,1,1,1,1,1,1,1,1,1,1,1,1,0,1,1,0,3],
			[1,1,1,1,1,1,1,1,1,1,1,1,1,1,3,1,1,1,1,1,0,1,0,0,0,1],
			[1,1,1,1,1,1,1,1,1,1,1,3,0,0,0,1,1,1,1,0,1,1,0,0,1,1],
			[1,1,1,1,1,1,1,1,0,0,0,0,1,1,0,0,0,1,0,1,1,0,1,0,1,1],
			[1,1,1,1,1,0,0,0,1,1,1,1,1,1,3,1,0,0,1,1,0,1,1,0,0,1],
			[1,1,1,1,0,3,1,1,1,1,1,3,0,0,0,1,1,1,1,0,1,1,0,0,0,1],
			[1,1,1,0,1,1,1,1,0,0,0,0,1,1,0,0,0,1,0,1,1,1,0,0,0,1],
			[1,0,0,1,1,0,0,0,1,1,1,1,1,1,3,1,0,0,1,1,1,1,0,0,3,1],
			[1,1,1,1,0,3,1,1,1,1,1,1,1,1,1,1,1,1,1,1,1,1,1,0,1,1],
			[1,1,1,0,1,1,1,1,1,1,1,1,1,1,1,1,1,1,1,1,1,1,1,0,0,1],
			[1,0,0,1,1,1,1,1,1,1,1,1,1,1,1,1,1,1,1,1,1,1,0,0,0,1],
			[1,1,1,1,1,1,1,1,1,1,1,1,1,1,1,1,1,1,1,1,1,1,0,0,1,1],
			[1,1,1,1,1,1,1,1,1,1,1,1,1,1,1,1,1,1,1,1,1,1,1,1,1,1]
		],
		[
			[1,1,1,1,1,1,1,1,1,1,1,1,1,1,1,1,1,1,1,1,1,1,1,1,1,1],
			[1,1,1,1,1,1,1,1,1,1,1,1,1,1,1,1,1,1,1,1,1,1,1,0,0,1],
			[1,1,1,1,1,1,1,1,1,1,1,1,1,1,1,1,1,1,1,1,1,1,0,0,0,1],
			[1,1,1,1,1,1,1,1,1,1,1,1,1,1,1,1,1,1,1,1,1,1,0,0,1,1],
			[1,1,1,1,1,1,1,1,1,1,1,1,1,1,1,1,1,1,1,1,1,1,1,0,1,1],
			[1,1,1,1,1,1,1,1,1,1,1,1,1,1,1,1,1,1,1,1,1,1,1,0,0,1],
			[1,1,1,1,1,1,1,1,1,1,1,1,1,1,1,1,1,1,1,1,1,1,0,0,0,1],
			[1,1,1,1,1,1,1,1,1,1,1,1,1,1,1,1,1,1,1,1,1,1,0,0,0,1],
			[1,1,1,1,1,1,1,1,1,1,1,1,1,1,1,1,1,1,1,1,1,1,0,0,1,1],
			[1,1,1,1,1,1,1,1,1,1,1,1,1,1,1,1,1,1,1,1,1,1,1,0,1,1],
			[1,1,1,1,1,1,1,1,1,1,1,1,1,1,1,1,1,1,1,1,1,1,1,0,0,1],
			[1,1,1,1,1,1,1,1,1,1,1,1,1,1,1,1,1,1,1,1,1,1,0,0,0,1],
			[1,1,1,1,1,1,1,1,1,1,1,1,1,1,1,1,1,1,1,1,1,1,0,1,1,1],
			[1,1,1,1,1,1,1,1,1,1,1,1,1,1,1,1,1,1,1,1,1,1,1,1,0,1],
			[1,1,1,1,1,1,1,1,1,1,1,1,1,1,1,1,1,1,1,1,0,1,0,0,0,1],
			[1,1,1,1,1,1,1,1,1,1,1,1,0,0,0,1,1,1,1,0,1,1,0,0,1,1],
			[1,1,1,1,1,1,1,1,0,0,0,0,1,1,0,0,0,1,0,1,1,1,1,0,1,1],
			[1,1,1,1,1,0,0,0,1,1,1,1,1,1,1,1,0,0,1,1,0,1,1,0,0,1],
			[1,1,1,1,0,1,1,1,1,1,1,1,0,0,0,1,1,1,1,0,1,1,0,0,0,1],
			[1,1,1,0,1,1,1,1,0,0,0,0,1,1,0,0,0,1,0,1,1,1,0,0,0,1],
			[1,0,0,1,1,0,0,0,1,1,1,1,1,1,1,1,0,0,1,1,1,1,0,0,1,1],
			[1,1,1,1,0,1,1,1,1,1,1,1,1,1,1,1,1,1,1,1,1,1,1,0,1,1],
			[1,1,1,0,1,1,1,1,1,1,1,1,1,1,1,1,1,1,1,1,1,1,1,0,0,1],
			[1,0,0,1,1,1,1,1,1,1,1,1,1,1,1,1,1,1,1,1,1,1,0,0,0,1],
			[1,1,1,1,1,1,1,1,1,1,1,1,1,1,1,1,1,1,1,1,1,1,0,0,1,1],
			[1,1,1,1,1,1,1,1,1,1,1,1,1,1,1,1,1,1,1,1,1,1,1,1,1,1]
		]
	],

	"player": [
		{"x":1,"y":20,"hp":100},
		{"x":1,"y":23,"hp":100}
	],

	"enemy": [
		{"kind":"koro","x":4,"y":18,"mapIndex":1},
		{"kind":"koro","x":4,"y":21,"mapIndex":1},
		{"kind":"koro","x":12,"y":18,"mapIndex":1},
		{"kind":"koro","x":12,"y":15,"mapIndex":1},
		{"kind":"koro","x":23,"y":6,"mapIndex":1},
		{"kind":"koro","x":23,"y":7,"mapIndex":1},
		{"kind":"koro","x":23,"y":18,"mapIndex":1},
		{"kind":"koro","x":23,"y":19,"mapIndex":1}
	],

	"item": [
		{"type":"star","x":23,"y":23},
		{"type":"star","x":23,"y":2},
		{"type":"coin","x":3,"y":19},
		{"type":"coin","x":3,"y":22},
		{"type":"coin","x":7,"y":17},
		{"type":"coin","x":7,"y":20},
		{"type":"coin","x":11,"y":16},
		{"type":"coin","x":11,"y":19},
		{"type":"coin","x":16,"y":16},
		{"type":"coin","x":22,"y":12},
		{"type":"coin","x":22,"y":15},
		{"type":"coin","x":16,"y":19},
		{"type":"coin","x":22,"y":6},
		{"type":"coin","x":24,"y":7},
		{"type":"coin","x":22,"y":18},
		{"type":"coin","x":24,"y":19}
	]
}