{
	"name": "test stage",
	"icon": 4,
	"mark": 4,
	"wall1": 31,
	"wall2": 32,
	"bgmId": 2,

	"health": 9,
	"gravityPower": 0.1,
	"openStage": 5,
	"openStory": -1,
	"openPuppet": -1,

	"map": [
		[
			[1,1,1,1,1,1,1,1,1,1,1,1,1,1,1,1,1,1,1,1,1,1,1,1,1,1,1,1,1,1,1,1],
			[1,1,1,1,1,1,1,1,1,1,1,1,1,1,1,1,1,1,1,1,1,1,1,1,1,1,1,1,1,1,1,1],
			[1,1,1,1,1,1,1,1,1,1,1,1,1,1,1,1,1,1,1,1,1,1,1,1,1,1,1,1,1,1,1,1],
			[1,1,1,1,1,1,1,1,1,1,1,1,1,1,1,1,1,1,1,1,1,1,1,1,1,1,1,1,1,1,1,1],
			[1,1,1,1,1,1,1,1,1,1,1,1,1,1,1,1,1,1,1,1,1,1,1,1,1,1,1,1,1,1,1,1],
			[1,1,1,1,1,1,1,1,1,0,0,0,1,1,1,1,1,1,1,1,1,1,1,1,1,1,1,1,1,1,1,1],
			[1,1,1,1,1,1,1,1,1,1,1,0,1,1,1,1,1,1,1,1,1,0,0,0,0,0,0,1,1,1,1,1],
			[1,1,1,1,1,1,1,1,1,1,0,1,1,1,1,1,1,1,1,1,0,0,0,1,1,1,0,1,1,1,1,1],
			[1,1,1,1,1,1,1,1,1,1,0,1,1,1,1,1,1,1,1,0,0,0,1,1,0,0,1,1,1,1,1,1],
			[1,1,1,1,1,1,1,1,1,0,1,1,1,1,1,1,1,1,0,0,0,1,1,0,1,1,1,1,1,1,1,1],
			[1,1,1,1,1,1,1,1,1,0,1,1,0,0,0,1,1,0,0,0,1,3,0,1,1,1,1,1,1,1,1,1],
			[1,1,1,1,1,1,1,1,0,1,1,0,0,0,0,1,0,4,1,1,1,0,1,1,1,1,1,1,1,1,1,1],
			[1,1,1,1,1,1,1,1,0,1,0,0,0,0,0,1,0,1,1,1,0,1,1,1,1,1,1,1,1,1,1,1],
			[1,1,1,1,1,1,1,0,0,0,0,0,0,0,0,0,1,1,1,0,1,1,1,1,0,0,1,1,1,1,1,1],
			[1,1,1,1,1,1,1,1,1,1,0,0,0,1,1,1,1,1,0,1,1,1,1,0,0,0,1,1,1,1,1,1],
			[1,1,1,1,1,1,1,1,1,1,1,1,1,1,1,1,1,0,1,1,1,1,1,0,0,1,1,1,1,1,1,1],
			[1,1,1,1,1,1,1,1,1,1,1,1,1,1,1,1,0,3,1,1,1,3,0,1,1,1,1,1,1,1,1,1],
			[1,1,1,1,1,1,0,0,1,1,1,1,1,1,1,0,1,1,1,1,1,0,3,1,1,1,1,1,1,1,1,1],
			[1,1,1,1,1,0,0,0,1,1,1,1,1,1,0,1,1,1,1,1,0,1,1,1,1,1,1,1,1,1,1,1],
			[1,2,1,1,0,0,0,0,1,1,2,1,1,0,1,1,1,1,1,0,1,1,1,1,1,1,1,1,1,1,1,1],
			[1,0,0,0,0,0,0,0,0,0,1,1,0,1,1,1,1,3,0,1,1,1,1,1,1,1,1,1,1,1,1,1],
			[1,0,1,0,0,0,0,1,0,1,3,0,1,1,1,1,1,0,3,1,1,1,1,1,1,1,1,1,1,1,1,1],
			[1,0,1,0,0,0,1,0,1,1,0,1,1,1,1,1,0,1,1,1,1,1,1,1,1,1,1,1,1,1,1,1],
			[1,0,1,0,0,1,0,1,1,0,1,1,1,1,1,0,1,1,1,1,1,1,1,1,1,1,1,1,1,1,1,1],
			[1,0,1,1,1,0,1,1,0,1,1,1,0,0,4,1,1,1,1,1,1,1,1,1,1,1,1,1,1,1,1,1],
			[1,0,1,1,0,1,1,0,3,1,1,0,1,0,0,1,1,1,1,1,1,1,1,1,1,1,1,1,1,1,1,1],
			[1,0,1,1,0,0,0,1,1,1,0,1,0,1,0,1,1,1,1,1,1,1,1,1,1,1,1,1,1,1,1,1],
			[1,0,1,1,1,1,1,1,1,0,1,0,1,0,1,1,1,1,1,1,1,1,1,1,1,1,1,1,1,1,1,1],
			[1,0,1,1,1,1,1,1,1,1,0,1,0,1,1,1,1,1,1,1,1,1,1,1,1,1,1,1,1,1,1,1],
			[1,0,1,0,0,1,0,0,1,0,1,0,1,1,1,1,1,1,1,1,1,1,1,1,1,1,1,1,1,1,1,1],
			[1,0,0,1,0,0,3,0,0,1,1,1,1,1,1,1,1,1,1,1,1,1,1,1,1,1,1,1,1,1,1,1],
			[1,1,1,1,1,1,1,1,1,1,1,1,1,1,1,1,1,1,1,1,1,1,1,1,1,1,1,1,1,1,1,1]
		],
		[
			[1,1,1,1,1,1,1,1,1,1,1,1,1,1,1,1,1,1,1,1,1,1,1,1,1,1,1,1,1,1,1,1],
			[1,1,1,1,1,1,1,1,1,1,1,1,1,1,1,1,1,1,1,1,1,1,1,1,1,1,1,1,1,1,1,1],
			[1,1,1,1,1,1,1,1,1,1,1,1,1,1,1,1,1,1,1,1,1,1,1,1,1,1,1,1,1,1,1,1],
			[1,1,1,1,1,1,1,1,1,1,1,1,1,1,1,1,1,1,1,1,1,1,1,1,1,1,1,1,1,1,1,1],
			[1,1,1,1,1,1,1,1,1,1,1,1,1,1,1,1,1,1,1,1,1,1,1,1,1,1,1,1,1,1,1,1],
			[1,1,1,1,1,1,1,1,1,1,1,1,1,1,1,1,1,1,1,1,1,1,1,1,1,1,1,1,1,1,1,1],
			[1,1,1,1,1,1,1,1,1,1,1,1,1,1,1,1,1,1,1,1,1,1,1,1,1,1,1,1,1,1,1,1],
			[1,1,1,1,1,1,1,1,1,1,1,1,1,1,1,1,1,1,1,1,1,1,1,1,1,1,1,1,1,1,1,1],
			[1,1,1,1,1,1,1,1,1,1,1,1,1,1,1,1,1,1,1,1,1,1,1,1,1,1,1,1,1,1,1,1],
			[1,1,1,1,1,1,1,1,1,1,1,1,1,1,1,1,1,1,1,1,1,1,1,1,1,1,1,1,1,1,1,1],
			[1,1,1,1,1,1,1,1,1,1,1,1,0,0,0,1,1,1,1,1,1,1,1,1,1,1,1,1,1,1,1,1],
			[1,1,1,1,1,1,1,1,1,1,1,0,0,0,0,1,1,1,1,1,1,1,1,1,1,1,1,1,1,1,1,1],
			[1,1,1,1,1,1,1,1,1,1,0,0,0,0,0,1,1,1,1,1,1,1,1,1,1,1,1,1,1,1,1,1],
			[1,1,1,1,1,1,1,1,1,1,0,0,0,0,1,1,1,1,1,1,1,1,1,1,1,1,1,1,1,1,1,1],
			[1,1,1,1,1,1,1,1,1,1,0,0,0,1,1,1,1,1,1,1,1,1,1,1,1,1,1,1,1,1,1,1],
			[1,1,1,1,1,1,1,1,1,1,1,1,1,1,1,1,1,1,1,1,1,1,1,1,1,1,1,1,1,1,1,1],
			[1,1,1,1,1,1,1,1,1,1,1,1,1,1,1,1,1,1,1,1,1,1,1,1,1,1,1,1,1,1,1,1],
			[1,1,1,1,1,1,0,0,1,1,1,1,1,1,1,1,1,1,1,1,1,1,1,1,1,1,1,1,1,1,1,1],
			[1,1,1,1,1,0,0,0,1,1,1,1,1,1,1,1,1,1,1,1,1,1,1,1,1,1,1,1,1,1,1,1],
			[1,1,1,1,0,0,0,0,1,1,1,1,1,1,1,1,1,1,1,1,1,1,1,1,1,1,1,1,1,1,1,1],
			[1,1,1,0,0,0,0,0,1,1,1,1,1,1,1,1,1,1,1,1,1,1,1,1,1,1,1,1,1,1,1,1],
			[1,1,1,0,0,0,0,1,1,1,1,1,1,1,1,1,1,1,1,1,1,1,1,1,1,1,1,1,1,1,1,1],
			[1,1,1,0,0,0,1,1,1,1,1,1,1,1,1,1,1,1,1,1,1,1,1,1,1,1,1,1,1,1,1,1],
			[1,1,1,0,0,1,1,1,1,1,1,1,1,1,1,1,1,1,1,1,1,1,1,1,1,1,1,1,1,1,1,1],
			[1,1,1,1,1,1,1,1,1,1,1,1,1,1,1,1,1,1,1,1,1,1,1,1,1,1,1,1,1,1,1,1],
			[1,1,1,1,1,1,1,1,1,1,1,1,1,1,1,1,1,1,1,1,1,1,1,1,1,1,1,1,1,1,1,1],
			[1,1,1,1,1,1,1,1,1,1,1,1,1,1,1,1,1,1,1,1,1,1,1,1,1,1,1,1,1,1,1,1],
			[1,1,1,1,1,1,1,1,1,1,1,1,1,1,1,1,1,1,1,1,1,1,1,1,1,1,1,1,1,1,1,1],
			[1,1,1,1,1,1,1,1,1,1,1,1,1,1,1,1,1,1,1,1,1,1,1,1,1,1,1,1,1,1,1,1],
			[1,1,1,1,1,1,1,1,1,1,1,1,1,1,1,1,1,1,1,1,1,1,1,1,1,1,1,1,1,1,1,1],
			[1,1,1,1,1,1,1,1,1,1,1,1,1,1,1,1,1,1,1,1,1,1,1,1,1,1,1,1,1,1,1,1],
			[1,1,1,1,1,1,1,1,1,1,1,1,1,1,1,1,1,1,1,1,1,1,1,1,1,1,1,1,1,1,1,1]
		]
	],

	"player": [
		{"x":9,"y":5,"hp":100}
	],

	"enemy": [
		{"kind":"koro","x":13,"y":10,"mapIndex":1},
		{"kind":"bone","x":6,"y":18,"mapIndex":1},
		{"kind":"bone","x":5,"y":20,"mapIndex":1},
		{"kind":"bone","x":4,"y":22,"mapIndex":1}
	],

	"item": [
		{"type":"coin","x":12,"y":12},
		{"type":"coin","x":5,"y":19},
		{"type":"coin","x":4,"y":20},
		{"type":"coin","x":4,"y":21},
		{"type":"coin","x":5,"y":21},
		{"type":"coin","x":6,"y":20},
		{"type":"coin","x":6,"y":19},
		{"type":"coin","x":9,"y":27},
		{"type":"coin","x":10,"y":26},
		{"type":"coin","x":11,"y":25},
		{"type":"coin","x":12,"y":24},
		{"type":"coin","x":11,"y":29},
		{"type":"coin","x":12,"y":28},
		{"type":"coin","x":13,"y":27},
		{"type":"coin","x":14,"y":26},
		{"type":"coin","x":20,"y":12},
		{"type":"coin","x":15,"y":17},
		{"type":"coin","x":11,"y":21},
		{"type":"coin","x":19,"y":9},
		{"type":"coin","x":20,"y":8},
		{"type":"coin","x":21,"y":7},
		{"type":"coin","x":1,"y":22},
		{"type":"coin","x":1,"y":27},
		{"type":"coin","x":4,"y":29},
		{"type":"coin","x":7,"y":29},
		{"type":"star","x":24,"y":14},
		{"type":"coin","x":23,"y":15},
		{"type":"coin","x":23,"y":14},
		{"type":"coin","x":24,"y":13},
		{"type":"coin","x":25,"y":14},
		{"type":"coin","x":25,"y":13},
		{"type":"coin","x":24,"y":15}
	]
}