{
	"name": "test stage",
	"icon": 22,
	"mark": 22,
	"wall1": 11,
	"wall2": 12,
	"bgmId": 4,

	"health": 9,
	"gravityPower": 0.1,
	"openStage": 23,
	"openStory": -1,
	"openPuppet": -1,

	"map": [
		[
			[1,1,1,1,1,1,1,1,1,1,1,1,1,1,1,1,1,1,1,1,1,1,1,1,1,1,1,1,1,1,1,1],
			[1,1,0,0,0,0,0,1,1,0,0,1,0,0,0,1,1,0,0,1,0,0,1,0,0,0,1,0,1,0,0,1],
			[1,0,1,1,1,1,0,0,0,1,1,0,1,1,0,1,0,1,0,0,1,1,0,1,1,0,1,0,0,1,0,1],
			[1,0,1,0,1,0,1,1,0,0,0,1,1,1,0,1,1,1,1,0,0,0,1,0,0,1,0,1,1,1,1,1],
			[1,1,0,1,0,1,1,0,1,1,1,0,0,0,1,1,0,0,1,1,1,0,1,1,1,1,0,0,0,0,0,1],
			[1,1,0,0,1,0,1,0,0,1,0,0,0,0,1,0,0,0,0,0,1,0,0,0,0,0,1,1,1,1,0,1],
			[1,0,1,0,0,1,0,1,1,0,0,0,0,0,1,0,0,1,1,0,1,1,1,1,1,0,1,0,1,0,1,1],
			[1,0,1,1,0,1,0,1,0,0,0,0,0,0,1,1,1,0,0,1,0,0,0,0,1,0,0,1,1,0,0,1],
			[1,0,0,1,0,1,1,1,0,0,0,0,0,1,0,0,0,1,1,1,1,1,1,0,1,1,0,0,1,1,0,1],
			[1,1,0,1,0,0,1,1,0,0,0,0,1,0,1,1,1,0,0,0,0,0,1,0,0,1,1,0,0,1,0,1],
			[1,0,1,1,1,0,0,1,0,0,0,1,0,1,0,0,1,1,1,1,1,0,1,1,0,0,1,1,0,1,0,1],
			[1,0,0,0,1,1,0,1,1,1,1,0,1,0,1,1,0,0,0,0,1,0,1,0,1,0,1,0,1,0,1,1],
			[1,1,1,0,1,0,1,0,1,0,0,1,0,1,0,0,1,1,1,0,1,0,1,0,1,0,1,0,1,0,0,1],
			[1,0,0,1,0,1,0,1,0,1,0,0,1,0,1,1,0,0,1,0,0,1,0,1,0,1,1,0,1,1,0,1],
			[1,1,1,0,1,0,1,0,1,0,1,0,0,1,0,0,1,1,0,1,0,0,1,0,1,0,1,0,1,0,1,1],
			[1,0,0,1,0,1,0,1,0,1,0,1,1,0,1,0,0,0,1,0,1,0,1,0,1,0,1,0,1,0,0,1],
			[1,1,0,0,1,0,1,0,1,0,1,0,0,1,0,1,1,0,1,0,1,0,1,0,0,1,0,1,1,1,0,1],
			[1,0,1,1,0,1,0,1,0,1,0,1,0,1,0,0,1,0,1,0,1,0,1,1,1,0,1,0,1,0,1,1],
			[1,0,0,1,0,1,0,1,0,1,0,1,1,1,1,0,1,1,0,1,0,1,0,0,0,1,0,1,1,0,0,1],
			[1,1,0,1,0,1,0,1,0,1,1,0,0,0,0,1,0,0,1,0,1,0,1,1,0,1,0,1,1,1,0,1],
			[1,0,1,1,0,1,0,1,1,1,0,1,1,1,1,1,1,1,0,1,0,1,0,0,1,0,1,0,0,1,0,1],
			[1,0,1,0,1,1,0,0,0,1,0,0,0,0,0,0,0,1,1,0,1,0,1,1,0,1,0,0,0,1,0,1],
			[1,0,1,1,0,0,1,1,1,1,1,1,1,1,1,1,1,0,0,1,0,1,0,0,1,1,0,0,1,1,0,1],
			[1,0,1,1,1,0,0,0,0,0,0,0,0,0,1,0,0,1,1,0,1,0,1,0,0,1,1,0,0,0,1,1],
			[1,0,0,0,1,1,1,1,1,1,1,1,1,0,0,1,1,0,0,1,0,1,0,1,0,0,1,1,1,1,0,1],
			[1,1,1,0,0,0,1,0,0,1,0,0,1,1,1,0,0,1,1,0,1,0,1,1,1,0,0,0,0,0,1,1],
			[1,0,1,1,1,0,0,1,0,0,1,0,0,0,0,1,0,1,0,1,1,0,1,0,1,1,1,1,1,0,0,1],
			[1,0,0,0,1,1,0,1,1,1,1,1,1,1,0,1,0,1,0,0,1,0,1,0,0,0,0,1,1,1,1,1],
			[1,1,1,0,1,0,1,0,0,0,0,0,0,1,0,1,0,0,1,0,1,0,1,1,1,1,0,0,0,0,0,1],
			[1,0,0,1,1,0,1,1,1,1,1,1,0,0,1,0,1,0,1,0,1,0,0,0,0,1,1,1,1,1,0,1],
			[1,1,0,0,0,1,0,0,0,0,0,0,1,1,0,1,0,1,0,1,0,1,1,1,0,0,0,0,0,0,1,1],
			[1,1,1,1,1,1,1,1,1,1,1,1,1,1,1,1,1,1,1,1,1,1,1,1,1,1,1,1,1,1,1,1]
		]
	],

	"player": [
		{"x":17,"y":13,"hp":100}
	],

	"enemy": [

	],

	"item": [
		{"type":"star","x":27,"y":21},
		{"type":"coin","x":15,"y":14},
		{"type":"coin","x":26,"y":4},
		{"type":"coin","x":25,"y":5},
		{"type":"coin","x":24,"y":18},
		{"type":"coin","x":5,"y":22},
		{"type":"coin","x":6,"y":21},
		{"type":"coin","x":10,"y":13},
		{"type":"coin","x":11,"y":13},
		{"type":"coin","x":11,"y":14},
		{"type":"coin","x":19,"y":13},
		{"type":"coin","x":15,"y":15},
		{"type":"coin","x":17,"y":15},
		{"type":"coin","x":15,"y":6},
		{"type":"coin","x":15,"y":5},
		{"type":"coin","x":16,"y":5},
		{"type":"coin","x":16,"y":4},
		{"type":"coin","x":17,"y":4},
		{"type":"coin","x":16,"y":6},
		{"type":"coin","x":17,"y":5},
		{"type":"coin","x":26,"y":21},
		{"type":"coin","x":27,"y":20},
		{"type":"coin","x":28,"y":20},
		{"type":"coin","x":28,"y":21},
		{"type":"coin","x":27,"y":22},
		{"type":"coin","x":26,"y":22},
		{"type":"coin","x":9,"y":7},
		{"type":"coin","x":8,"y":7},
		{"type":"coin","x":9,"y":6},
		{"type":"coin","x":8,"y":8},
		{"type":"coin","x":9,"y":8},
		{"type":"coin","x":8,"y":9},
		{"type":"coin","x":8,"y":10},
		{"type":"coin","x":9,"y":9},
		{"type":"coin","x":9,"y":10},
		{"type":"coin","x":10,"y":10},
		{"type":"coin","x":10,"y":9},
		{"type":"coin","x":11,"y":9},
		{"type":"coin","x":11,"y":8},
		{"type":"coin","x":12,"y":8},
		{"type":"coin","x":10,"y":8},
		{"type":"coin","x":10,"y":7},
		{"type":"coin","x":11,"y":7},
		{"type":"coin","x":12,"y":7},
		{"type":"coin","x":13,"y":7},
		{"type":"coin","x":13,"y":6},
		{"type":"coin","x":13,"y":5},
		{"type":"coin","x":13,"y":4},
		{"type":"coin","x":12,"y":4},
		{"type":"coin","x":11,"y":4},
		{"type":"coin","x":10,"y":5},
		{"type":"coin","x":11,"y":5},
		{"type":"coin","x":12,"y":5},
		{"type":"coin","x":12,"y":6},
		{"type":"coin","x":11,"y":6},
		{"type":"coin","x":10,"y":6}
	]
}