{
	"name": "test stage",
	"icon": 5,
	"mark": 5,
	"wall1": 31,
	"wall2": 32,
	"bgmId": 2,

	"health": 9,
	"gravityPower": 0.1,
	"openStage": 6,
	"openStory": -1,
	"openPuppet": -1,

	"map": [
		[
			[1,1,1,1,1,1,1,1,1,1,1,1,1,1,1,1,1,1,1,1,1,1,1,1,1,1,1,1],
			[1,1,1,1,1,1,1,1,1,1,1,1,1,1,1,1,1,1,1,1,1,1,1,1,1,0,0,1],
			[1,1,1,1,1,1,1,1,1,1,1,1,1,1,1,0,0,0,0,0,0,0,0,0,0,0,0,1],
			[1,1,1,1,1,1,1,1,1,1,1,1,1,1,0,1,1,1,1,1,1,1,1,1,0,0,1,1],
			[1,1,1,1,1,1,1,1,1,1,1,1,1,0,1,0,0,0,0,0,0,0,0,1,1,1,1,1],
			[1,1,1,1,1,1,1,1,1,1,1,1,0,1,0,1,1,1,1,1,1,3,0,1,1,1,1,1],
			[1,1,1,1,1,1,1,1,1,1,1,0,1,0,1,0,0,0,0,0,0,1,0,1,1,1,1,1],
			[1,1,1,1,1,1,1,1,1,1,0,1,0,1,0,1,1,1,1,3,0,1,0,1,1,1,1,1],
			[1,1,1,1,1,1,1,1,1,0,1,0,1,0,1,0,0,0,0,1,0,1,0,1,1,1,1,1],
			[1,1,1,1,1,1,1,1,0,1,0,1,0,1,0,1,1,3,0,1,0,1,0,1,1,1,1,1],
			[1,1,1,1,1,1,1,0,3,0,3,0,3,0,1,0,0,1,0,1,0,1,0,1,1,1,1,1],
			[1,1,1,1,1,1,1,0,1,0,1,0,1,0,0,0,0,1,0,1,0,1,0,1,1,1,1,1],
			[1,1,1,1,1,1,1,0,1,0,1,0,1,0,0,1,0,1,0,1,0,1,0,1,1,1,1,1],
			[1,1,1,1,1,1,1,0,1,0,1,0,1,1,1,0,1,0,1,0,1,0,1,1,1,1,1,1],
			[1,1,1,1,1,1,1,0,1,0,1,0,0,0,0,1,0,1,0,1,0,1,1,1,1,1,1,1],
			[1,1,1,1,1,1,1,0,1,0,1,1,1,1,3,0,1,0,1,0,1,1,1,1,1,1,1,1],
			[1,1,1,1,1,1,1,0,1,0,0,0,0,0,0,1,0,1,0,1,1,1,1,1,1,1,1,1],
			[1,1,1,1,1,1,1,0,1,1,1,1,1,1,3,0,1,0,1,1,1,1,1,1,1,1,1,1],
			[1,1,1,0,0,0,1,0,0,0,0,0,0,0,0,1,0,1,1,1,1,1,1,1,1,1,1,1],
			[1,1,0,0,0,0,1,1,1,1,1,1,1,1,3,0,1,1,1,1,1,1,1,1,1,1,1,1],
			[1,0,0,0,0,0,0,0,0,0,0,0,0,0,0,1,1,1,1,1,1,1,1,1,1,1,1,1],
			[1,1,1,1,1,1,1,1,1,1,1,1,1,1,1,1,1,1,1,1,1,1,1,1,1,1,1,1]
		]
	],

	"player": [
		{"x":3,"y":19,"hp":100}
	],

	"enemy": [

	],

	"item": [
		{"type":"star","x":25,"y":2},
		{"type":"coin","x":14,"y":20},
		{"type":"coin","x":14,"y":18},
		{"type":"coin","x":14,"y":16},
		{"type":"coin","x":11,"y":10},
		{"type":"coin","x":9,"y":10},
		{"type":"coin","x":7,"y":10},
		{"type":"coin","x":18,"y":8},
		{"type":"coin","x":20,"y":6},
		{"type":"coin","x":22,"y":4},
		{"type":"coin","x":14,"y":11},
		{"type":"coin","x":14,"y":12},
		{"type":"coin","x":15,"y":11},
		{"type":"coin","x":15,"y":10}
	]
}