{
	"name": "test stage",
	"icon": 27,
	"mark": 27,
	"wall1": 11,
	"wall2": 12,
	"bgmId": 4,

	"health": 9,
	"gravityPower": 0.1,
	"openStage": -1,
	"openStory": 5,
	"openPuppet": -1,

	"map": [
		[
			[1,1,1,1,1,1,1,1,1,1,1,1,1,1,1,1,1,1,1,1,1,1,1,1,1,1,1,1,1,1,1,1],
			[1,1,1,1,1,1,1,1,1,1,1,1,1,1,1,1,1,1,1,0,0,1,1,1,1,1,0,0,1,1,1,1],
			[1,1,1,1,1,1,1,1,1,1,1,1,1,1,1,1,1,1,0,0,0,1,1,1,1,0,0,0,1,1,1,1],
			[1,1,1,1,1,1,1,1,1,1,1,1,1,1,1,1,1,1,0,0,1,1,1,1,1,0,0,1,1,1,1,1],
			[1,1,1,1,1,1,1,1,1,1,1,1,1,1,1,1,1,1,0,1,1,0,0,1,1,0,1,1,1,1,1,1],
			[1,1,1,1,1,1,1,1,1,1,1,1,1,1,1,24,0,0,0,0,0,1,0,0,0,0,0,12,1,1,1,1],
			[1,1,1,1,1,1,1,1,1,1,1,1,1,1,1,1,1,1,1,1,1,1,1,1,1,1,1,1,1,1,1,1],
			[1,1,1,1,1,1,1,1,1,1,1,1,1,1,1,1,1,1,1,1,1,1,1,1,1,1,1,1,1,1,1,1],
			[1,1,1,1,1,1,1,1,1,1,1,1,1,1,1,1,1,1,1,1,1,1,1,1,1,1,1,1,1,1,1,1],
			[1,1,1,1,1,1,1,1,1,1,1,1,1,1,1,1,1,1,1,1,1,1,1,1,1,1,1,1,1,1,1,1],
			[1,1,1,1,1,1,1,1,1,1,1,1,1,1,1,1,1,1,1,1,1,1,1,1,1,1,1,1,1,1,1,1],
			[1,1,1,1,1,1,1,1,1,1,1,1,1,1,1,1,1,1,1,1,1,1,1,1,1,1,1,1,1,1,1,1],
			[1,1,1,1,1,1,1,1,1,1,1,1,1,1,1,1,1,1,1,1,1,1,1,1,1,1,1,1,1,1,1,1],
			[1,1,1,1,1,1,1,1,1,1,1,1,1,1,1,1,1,1,1,1,1,1,1,1,1,1,1,1,1,1,1,1],
			[1,1,1,1,1,1,1,1,1,1,1,1,1,1,1,1,1,1,1,1,1,1,1,1,1,1,1,1,1,1,1,1],
			[1,1,1,1,1,1,1,1,1,1,1,1,1,1,1,1,1,1,1,1,1,1,1,1,1,1,1,1,1,1,1,1],
			[1,1,1,1,1,1,1,1,1,1,1,1,1,1,1,1,1,1,1,1,1,1,1,1,1,1,1,1,1,1,1,1],
			[1,1,1,0,1,1,1,1,1,0,1,1,1,1,1,0,1,1,1,1,1,0,1,1,1,1,1,0,1,1,1,1],
			[1,1,1,1,1,1,1,1,1,1,1,1,1,1,1,1,1,1,1,1,1,1,1,1,1,1,1,1,1,1,1,1],
			[1,1,1,1,1,0,1,1,1,1,1,1,1,1,1,1,1,1,1,1,1,1,1,0,1,1,1,1,1,1,1,1],
			[1,1,1,1,1,1,1,1,1,1,1,1,1,1,1,1,1,1,1,1,1,1,1,1,1,1,1,1,1,1,1,1],
			[1,1,1,1,1,1,1,1,1,1,1,1,1,1,1,1,1,1,1,1,1,1,1,1,1,1,1,1,1,1,1,1],
			[1,1,1,1,1,1,1,1,1,1,1,1,1,1,1,1,1,1,1,1,1,1,1,1,1,1,1,1,1,1,1,1],
			[1,1,1,1,1,1,1,1,1,1,1,1,1,1,1,1,1,1,1,1,1,1,1,1,1,1,1,1,1,1,1,1],
			[1,1,1,1,1,1,1,1,1,1,1,1,1,1,1,1,1,1,1,1,1,1,1,1,1,1,1,1,1,1,1,1],
			[1,0,0,0,0,0,0,0,0,0,0,0,0,0,0,0,0,0,0,0,0,0,1,1,1,1,1,1,1,1,1,1],
			[1,0,0,0,0,0,0,0,0,0,0,0,0,0,0,0,0,0,0,0,0,1,1,1,1,1,1,1,1,1,1,1],
			[1,0,0,0,0,0,0,0,0,0,0,0,0,0,0,0,0,0,0,0,1,1,1,1,1,1,1,1,1,1,1,1],
			[1,0,0,0,0,0,0,0,0,0,0,0,0,0,0,0,0,0,0,1,1,1,1,1,1,1,1,1,1,1,1,1],
			[1,0,0,0,0,0,0,0,0,0,0,0,0,0,0,0,0,0,1,1,1,1,1,1,1,1,1,1,1,1,1,1],
			[1,0,0,0,0,0,0,0,0,0,0,0,0,0,0,0,0,1,1,1,1,1,1,1,1,1,1,1,1,1,1,1],
			[1,1,1,1,1,1,1,1,1,1,1,1,1,1,1,1,1,1,1,1,1,1,1,1,1,1,1,1,1,1,1,1]
		],
		[
			[1,1,1,1,1,1,1,1,1,1,1,1,1,1,1,1,1,1,1,1,1,1,1,1,1,1,1,1,1,1,1,1],
			[1,1,1,1,1,1,1,1,1,1,1,1,1,1,1,1,1,1,1,0,0,1,1,1,1,1,0,0,1,1,1,1],
			[1,1,1,1,1,1,1,1,1,1,1,1,1,1,1,1,1,1,0,0,0,1,1,1,1,0,0,0,1,1,1,1],
			[1,1,1,1,1,1,1,1,1,1,1,1,1,1,1,0,0,1,0,0,1,1,1,1,1,0,0,1,0,0,1,1],
			[1,1,1,1,1,1,1,1,1,1,1,1,1,1,0,1,0,1,0,1,1,0,0,1,1,0,1,0,1,0,1,1],
			[1,1,1,1,1,1,1,1,1,1,1,1,1,0,1,24,0,0,0,0,0,1,0,0,0,0,0,12,1,0,1,1],
			[1,1,1,1,1,1,1,1,1,1,1,1,1,0,1,1,1,1,1,1,1,1,1,1,1,1,1,1,0,1,1,1],
			[1,1,1,1,1,1,1,1,1,1,1,1,1,0,0,1,1,1,1,1,1,1,1,1,1,1,0,0,1,1,1,1],
			[1,1,1,1,1,1,1,1,1,1,1,1,1,0,0,1,1,1,1,0,0,1,1,1,1,0,0,1,1,1,1,1],
			[1,1,1,1,1,1,1,1,1,1,1,1,0,0,0,1,1,1,0,0,0,1,1,1,0,0,0,1,1,1,1,1],
			[1,1,1,1,1,1,1,1,1,0,0,1,0,0,1,0,0,0,0,0,1,0,0,1,0,0,0,0,0,1,1,1],
			[1,1,1,1,1,1,1,1,0,0,0,1,0,1,0,0,0,1,1,1,0,0,0,1,1,1,0,0,0,1,1,1],
			[1,1,1,1,1,0,0,1,0,0,1,0,0,0,0,0,1,0,0,0,0,0,0,0,0,1,0,0,0,0,0,1],
			[1,1,1,1,0,0,0,1,0,1,0,0,0,1,1,1,0,0,0,1,1,1,0,0,0,1,0,1,0,0,0,1],
			[1,1,1,1,0,0,0,0,0,1,0,0,1,0,0,0,0,0,0,0,0,1,0,0,1,0,0,1,0,0,1,1],
			[1,1,1,1,1,1,0,0,0,1,0,1,0,0,0,1,1,1,0,0,0,1,0,1,0,0,0,1,1,1,1,1],
			[1,1,1,0,0,1,0,0,1,0,0,1,0,0,0,0,0,1,0,0,1,0,0,0,0,0,0,0,0,1,1,1],
			[1,1,0,0,0,1,0,1,0,0,0,1,1,1,0,0,0,1,1,1,0,0,0,1,1,1,0,0,0,1,1,1],
			[1,1,0,0,0,0,0,0,0,0,1,1,1,1,0,0,1,1,1,1,0,0,1,0,0,0,0,0,1,1,1,1],
			[1,1,1,1,0,0,0,1,1,1,1,1,1,1,0,1,1,1,1,1,1,1,0,0,0,1,1,1,1,1,1,1],
			[1,1,1,1,0,0,1,1,1,1,1,1,1,0,0,1,1,1,1,1,1,1,0,0,1,1,1,1,1,1,1,1],
			[1,1,1,1,1,1,1,1,1,1,1,1,0,0,0,1,1,1,1,1,1,1,1,1,1,1,1,1,1,1,1,1],
			[1,1,1,1,1,1,1,1,1,1,1,0,0,0,0,1,1,1,1,1,1,1,1,1,1,1,1,1,1,1,1,1],
			[1,1,1,1,1,1,1,1,1,1,0,0,0,0,0,1,1,1,1,1,1,1,1,1,1,1,1,1,1,1,1,1],
			[1,1,1,1,1,1,1,1,1,0,0,0,0,0,0,1,1,1,1,1,1,1,1,1,1,1,1,1,1,1,1,1],
			[1,0,0,0,0,0,0,0,0,0,0,0,0,0,0,0,0,0,0,0,0,0,1,1,1,1,1,1,1,1,1,1],
			[1,0,0,0,0,0,0,0,0,0,0,0,0,0,0,0,0,0,0,0,0,1,1,1,1,1,1,1,1,1,1,1],
			[1,0,0,0,0,0,0,0,0,0,0,0,0,0,0,0,0,0,0,0,1,1,1,1,1,1,1,1,1,1,1,1],
			[1,0,0,0,0,0,0,0,0,0,0,0,0,0,0,0,0,0,0,1,1,1,1,1,1,1,1,1,1,1,1,1],
			[1,0,0,0,0,0,0,0,0,0,0,0,0,0,0,0,0,0,1,1,1,1,1,1,1,1,1,1,1,1,1,1],
			[1,0,0,0,0,0,0,0,0,0,0,0,0,0,0,0,0,1,1,1,1,1,1,1,1,1,1,1,1,1,1,1],
			[1,1,1,1,1,1,1,1,1,1,1,1,1,1,1,1,1,1,1,1,1,1,1,1,1,1,1,1,1,1,1,1]
		]
	],

	"player": [
		{"x":19,"y":2,"hp":100,"mapIndex":1}
	],

	"enemy": [

	],

	"item": [
		{"type":"star","x":26,"y":2},
		{"type":"coin","x":25,"y":3},
		{"type":"coin","x":25,"y":2},
		{"type":"coin","x":26,"y":1},
		{"type":"coin","x":27,"y":1},
		{"type":"coin","x":27,"y":2},
		{"type":"coin","x":26,"y":3},
		{"type":"coin","x":5,"y":13},
		{"type":"coin","x":3,"y":17},
		{"type":"coin","x":5,"y":19},
		{"type":"coin","x":7,"y":15},
		{"type":"coin","x":9,"y":11},
		{"type":"coin","x":9,"y":17},
		{"type":"coin","x":11,"y":13},
		{"type":"coin","x":13,"y":9},
		{"type":"coin","x":15,"y":11},
		{"type":"coin","x":19,"y":9},
		{"type":"coin","x":17,"y":13},
		{"type":"coin","x":13,"y":15},
		{"type":"coin","x":15,"y":17},
		{"type":"coin","x":19,"y":15},
		{"type":"coin","x":21,"y":11},
		{"type":"coin","x":23,"y":13},
		{"type":"coin","x":21,"y":17},
		{"type":"coin","x":25,"y":15},
		{"type":"coin","x":27,"y":17},
		{"type":"coin","x":23,"y":19},
		{"type":"coin","x":29,"y":13},
		{"type":"coin","x":27,"y":11},
		{"type":"coin","x":25,"y":9},
		{"type":"coin","x":2,"y":26},
		{"type":"coin","x":2,"y":27},
		{"type":"coin","x":2,"y":28},
		{"type":"coin","x":2,"y":29},
		{"type":"coin","x":3,"y":29},
		{"type":"coin","x":3,"y":28},
		{"type":"coin","x":3,"y":27},
		{"type":"coin","x":3,"y":26},
		{"type":"coin","x":4,"y":26},
		{"type":"coin","x":4,"y":27},
		{"type":"coin","x":4,"y":28},
		{"type":"coin","x":4,"y":29},
		{"type":"coin","x":6,"y":28},
		{"type":"coin","x":5,"y":28},
		{"type":"coin","x":5,"y":29},
		{"type":"coin","x":5,"y":27},
		{"type":"coin","x":5,"y":26},
		{"type":"coin","x":6,"y":26},
		{"type":"coin","x":6,"y":27},
		{"type":"coin","x":6,"y":29},
		{"type":"coin","x":7,"y":29},
		{"type":"coin","x":7,"y":27},
		{"type":"coin","x":7,"y":28},
		{"type":"coin","x":7,"y":26},
		{"type":"coin","x":8,"y":26},
		{"type":"coin","x":9,"y":26},
		{"type":"coin","x":10,"y":26},
		{"type":"coin","x":11,"y":26},
		{"type":"coin","x":12,"y":26},
		{"type":"coin","x":13,"y":26},
		{"type":"coin","x":14,"y":26},
		{"type":"coin","x":15,"y":26},
		{"type":"coin","x":16,"y":26},
		{"type":"coin","x":17,"y":26},
		{"type":"coin","x":18,"y":27},
		{"type":"coin","x":19,"y":26},
		{"type":"coin","x":18,"y":26},
		{"type":"coin","x":17,"y":28},
		{"type":"coin","x":16,"y":29},
		{"type":"coin","x":15,"y":29},
		{"type":"coin","x":16,"y":28},
		{"type":"coin","x":17,"y":27},
		{"type":"coin","x":15,"y":28},
		{"type":"coin","x":16,"y":27},
		{"type":"coin","x":15,"y":27},
		{"type":"coin","x":14,"y":28},
		{"type":"coin","x":14,"y":29},
		{"type":"coin","x":13,"y":29},
		{"type":"coin","x":14,"y":27},
		{"type":"coin","x":13,"y":28},
		{"type":"coin","x":12,"y":29},
		{"type":"coin","x":11,"y":29},
		{"type":"coin","x":12,"y":28},
		{"type":"coin","x":13,"y":27},
		{"type":"coin","x":12,"y":27},
		{"type":"coin","x":11,"y":27},
		{"type":"coin","x":11,"y":28},
		{"type":"coin","x":10,"y":27},
		{"type":"coin","x":9,"y":29},
		{"type":"coin","x":10,"y":29},
		{"type":"coin","x":10,"y":28},
		{"type":"coin","x":9,"y":28},
		{"type":"coin","x":8,"y":29},
		{"type":"coin","x":8,"y":28},
		{"type":"coin","x":9,"y":27},
		{"type":"coin","x":8,"y":27},
		{"type":"coin","x":20,"y":5},
		{"type":"coin","x":22,"y":5},
		{"type":"coin","x":17,"y":5},
		{"type":"coin","x":25,"y":5}
	]
}