{
	"name": "test stage",
	"icon": 24,
	"mark": 24,
	"wall1": 11,
	"wall2": 12,
	"bgmId": 4,

	"health": 9,
	"gravityPower": 0.1,
	"openStage": 25,
	"openStory": -1,
	"openPuppet": -1,

	"map": [
		[
			[1,1,1,1,1,1,1,1,1,1,1,1,1,1,1,1,1,1,1,1,1,1,1,1,1,1,1,1,1,1,1,1],
			[1,1,1,1,1,1,1,1,1,1,1,1,1,1,1,1,1,1,1,1,1,1,1,1,1,1,1,1,1,1,1,1],
			[1,1,1,1,1,1,1,1,1,1,1,1,1,1,1,1,1,1,1,1,1,1,1,1,1,1,1,1,1,1,1,1],
			[1,1,1,1,1,1,1,1,1,1,1,1,1,1,1,1,1,1,1,1,1,1,1,1,1,1,1,1,1,1,1,1],
			[1,1,1,1,1,1,1,1,1,1,1,1,1,1,1,1,1,1,1,1,1,1,1,1,1,1,1,1,1,1,1,1],
			[1,1,1,1,1,1,1,1,1,1,1,1,1,1,1,1,1,0,0,0,0,0,0,0,0,0,0,0,0,0,1,1],
			[1,1,1,1,1,1,1,1,1,1,16,1,1,1,1,1,0,1,1,1,1,1,1,1,1,1,1,1,1,0,1,1],
			[1,1,1,1,1,1,1,1,1,0,0,1,1,1,1,0,1,0,0,0,0,0,0,0,0,0,0,0,1,0,1,1],
			[1,1,1,1,1,1,1,1,0,0,0,1,1,1,0,1,0,0,0,0,0,0,0,0,0,0,0,0,1,0,1,1],
			[1,1,1,1,1,1,1,0,0,0,0,1,1,0,1,0,0,0,0,0,0,0,0,0,0,0,0,0,1,0,1,1],
			[1,1,1,1,1,1,0,0,0,0,0,1,0,1,0,0,0,0,0,0,0,0,0,0,0,0,0,0,1,0,1,1],
			[1,1,1,1,1,1,0,0,1,0,0,1,1,0,0,0,0,0,0,0,0,0,0,0,0,0,0,0,1,0,1,1],
			[1,1,1,1,1,1,0,1,1,0,0,1,0,0,0,0,0,1,1,1,1,1,1,0,0,0,0,0,1,0,1,1],
			[1,1,1,1,1,1,1,1,0,0,1,0,0,0,0,0,1,0,0,0,0,0,1,0,0,0,0,0,1,0,1,1],
			[1,1,1,1,1,1,1,0,0,0,0,0,0,0,0,1,0,1,1,1,1,0,1,0,0,0,0,0,1,0,1,1],
			[1,1,1,1,1,1,0,0,0,0,0,0,0,0,1,0,1,1,1,1,1,0,1,0,0,0,0,0,1,0,1,1],
			[1,1,1,1,1,1,1,1,1,1,1,1,1,1,1,1,1,1,1,1,1,0,1,0,0,0,0,0,1,0,1,1],
			[1,1,1,1,1,1,1,1,1,1,1,1,1,1,1,1,1,1,1,1,1,0,1,0,0,0,0,0,1,0,1,1],
			[1,1,1,1,1,1,1,1,1,1,1,1,1,1,1,1,1,1,1,1,0,1,0,0,0,0,0,1,0,1,1,1],
			[1,1,1,1,0,0,0,0,0,0,0,0,1,0,1,1,1,1,1,0,1,0,0,0,0,0,1,0,1,1,1,1],
			[1,1,1,1,0,0,0,0,0,0,0,0,1,0,1,1,1,1,0,1,0,0,0,0,0,1,0,1,1,1,1,1],
			[1,1,1,1,0,0,0,0,0,0,0,0,1,0,0,0,0,0,1,0,0,0,0,0,1,0,1,1,1,1,1,1],
			[1,1,1,1,0,0,0,0,0,0,0,0,1,1,1,1,1,1,0,0,0,0,0,1,0,1,1,1,1,1,1,1],
			[1,1,1,1,0,0,0,0,0,0,0,0,0,0,0,0,0,0,0,0,0,0,1,0,1,1,1,1,1,1,1,1],
			[1,1,1,1,1,1,1,0,0,0,0,0,0,0,0,0,0,0,0,0,0,1,0,1,1,1,1,1,1,1,1,1],
			[1,1,1,1,1,0,1,0,0,0,0,0,0,0,0,0,0,0,0,0,1,0,1,1,1,1,1,1,1,1,1,1],
			[1,1,1,1,1,0,1,0,0,0,0,0,0,0,0,0,0,0,0,1,0,1,1,1,1,1,1,1,1,1,1,1],
			[1,1,1,1,1,0,1,0,0,0,0,0,0,0,0,0,0,0,1,0,1,1,1,1,1,1,1,1,1,1,1,1],
			[1,1,1,1,1,0,1,1,1,1,1,1,1,1,1,1,1,1,0,1,1,1,1,1,1,1,1,1,1,1,1,1],
			[1,1,1,1,1,0,0,0,0,0,0,0,0,0,0,0,0,0,1,1,1,1,1,1,1,1,1,1,1,1,1,1],
			[1,1,1,1,1,1,1,1,1,1,1,1,1,1,1,1,1,1,1,1,1,1,1,1,1,1,1,1,1,1,1,1],
			[1,1,1,1,1,1,1,1,1,1,1,1,1,1,1,1,1,1,1,1,1,1,1,1,1,1,1,1,1,1,1,1]
		],
		[
			[1,1,1,1,1,1,1,1,1,1,1,1,1,1,1,1,1,1,1,1,1,1,1,1,1,1,1,1,1,1,1,1],
			[1,1,1,1,1,1,1,1,1,1,1,1,1,1,1,1,1,1,1,1,1,1,1,1,1,1,1,1,1,1,1,1],
			[1,1,1,1,1,1,1,1,1,1,1,1,1,1,1,1,1,1,1,1,1,1,1,1,1,1,1,1,1,1,1,1],
			[1,1,1,1,1,1,1,1,1,1,1,1,1,1,1,1,1,1,1,1,1,1,1,1,1,1,1,1,1,1,1,1],
			[1,1,1,1,1,1,1,1,1,1,1,1,1,1,1,1,1,1,1,1,1,1,1,1,1,1,1,1,1,1,1,1],
			[1,1,1,1,1,1,1,1,1,24,20,12,12,1,1,1,1,16,12,12,12,12,12,12,12,12,12,12,12,12,1,1],
			[1,1,1,1,1,1,1,1,4,1,16,1,8,1,1,1,16,12,8,8,8,8,8,8,8,8,8,8,8,8,1,1],
			[1,1,1,1,1,1,1,4,1,0,0,1,8,1,1,16,12,0,0,0,0,0,0,0,0,0,0,0,4,8,1,1],
			[1,1,1,1,1,1,4,1,0,0,0,1,8,1,16,12,0,0,0,0,0,0,0,0,0,0,0,0,4,8,1,1],
			[1,1,1,1,1,4,1,0,0,0,0,1,8,16,12,0,0,0,0,0,0,0,0,0,0,0,0,0,4,8,1,1],
			[1,1,1,1,4,1,0,0,0,0,0,1,8,12,0,0,0,0,0,0,0,0,0,0,0,0,0,0,4,8,1,1],
			[1,1,1,1,8,1,0,0,1,0,0,1,8,0,0,0,0,0,0,0,0,0,0,0,0,0,0,0,4,8,1,1],
			[1,1,1,1,8,1,0,1,1,0,0,1,0,0,0,0,0,20,16,16,16,16,16,0,0,0,0,0,4,8,1,1],
			[1,1,1,1,8,1,1,1,0,0,1,0,0,0,0,0,20,16,12,12,12,12,12,0,0,0,0,0,4,8,1,1],
			[1,1,1,1,8,1,1,0,0,0,0,0,0,0,0,20,16,1,1,1,1,8,12,0,0,0,0,0,4,8,1,1],
			[1,1,1,1,8,1,0,0,0,0,0,0,0,0,20,16,1,1,1,1,1,8,12,0,0,0,0,0,4,8,1,1],
			[1,1,1,1,8,1,1,1,1,1,1,1,1,16,16,1,1,1,1,1,1,8,12,0,0,0,0,0,4,8,1,1],
			[1,1,1,1,8,12,12,12,12,12,12,12,12,12,1,1,1,1,1,1,1,8,12,0,0,0,0,0,4,8,1,1],
			[1,1,1,1,1,1,1,1,1,1,1,1,1,1,1,1,1,1,1,1,4,8,0,0,0,0,0,24,4,1,1,1],
			[1,1,1,1,0,0,0,0,0,0,0,0,24,20,1,1,1,1,1,4,8,0,0,0,0,0,24,4,1,1,1,1],
			[1,1,1,1,0,0,0,0,0,0,0,0,24,20,1,1,1,1,4,8,0,0,0,0,0,24,4,1,1,1,1,1],
			[1,1,1,1,0,0,0,0,0,0,0,0,24,24,24,24,24,4,8,0,0,0,0,0,24,4,1,1,1,1,1,1],
			[1,1,1,1,0,0,0,0,0,0,0,0,4,4,4,4,4,8,0,0,0,0,0,24,4,1,1,1,1,1,1,1],
			[1,1,1,1,0,0,0,0,0,0,0,0,0,0,0,0,0,0,0,0,0,0,24,4,1,1,1,1,1,1,1,1],
			[1,1,1,1,1,1,16,0,0,0,0,0,0,0,0,0,0,0,0,0,0,24,4,1,1,1,1,1,1,1,1,1],
			[1,1,1,1,1,20,16,0,0,0,0,0,0,0,0,0,0,0,0,0,24,4,1,1,1,1,1,1,1,1,1,1],
			[1,1,1,1,1,20,16,0,0,0,0,0,0,0,0,0,0,0,0,24,4,1,1,1,1,1,1,1,1,1,1,1],
			[1,1,1,1,1,20,16,0,0,0,0,0,0,0,0,0,0,0,24,4,1,1,1,1,1,1,1,1,1,1,1,1],
			[1,1,1,1,1,20,20,20,20,20,20,20,20,20,20,20,20,24,4,1,1,1,1,1,1,1,1,1,1,1,1,1],
			[1,1,1,1,1,24,24,24,24,24,24,24,24,24,24,24,24,4,1,1,1,1,1,1,1,1,1,1,1,1,1,1],
			[1,1,1,1,1,1,1,1,1,1,1,1,1,1,1,1,1,1,1,1,1,1,1,1,1,1,1,1,1,1,1,1],
			[1,1,1,1,1,1,1,1,1,1,1,1,1,1,1,1,1,1,1,1,1,1,1,1,1,1,1,1,1,1,1,1]
		]
	],

	"player": [
		{"x":9,"y":8,"hp":100,"mapIndex":1}
	],

	"enemy": [

	],

	"item": [
		{"type":"star","x":4,"y":19},
		{"type":"coin","x":13,"y":13},
		{"type":"coin","x":15,"y":11},
		{"type":"coin","x":17,"y":9},
		{"type":"coin","x":19,"y":9},
		{"type":"coin","x":21,"y":9},
		{"type":"coin","x":23,"y":9},
		{"type":"coin","x":25,"y":9},
		{"type":"coin","x":25,"y":11},
		{"type":"coin","x":25,"y":13},
		{"type":"coin","x":25,"y":15},
		{"type":"coin","x":25,"y":17},
		{"type":"coin","x":23,"y":19},
		{"type":"coin","x":21,"y":21},
		{"type":"coin","x":19,"y":23},
		{"type":"coin","x":17,"y":25},
		{"type":"coin","x":15,"y":25},
		{"type":"coin","x":13,"y":25},
		{"type":"coin","x":11,"y":25},
		{"type":"coin","x":9,"y":25},
		{"type":"coin","x":9,"y":23},
		{"type":"coin","x":9,"y":21},
		{"type":"coin","x":7,"y":21},
		{"type":"coin","x":5,"y":21},
		{"type":"coin","x":13,"y":12},
		{"type":"coin","x":14,"y":11},
		{"type":"coin","x":16,"y":11},
		{"type":"coin","x":17,"y":10},
		{"type":"coin","x":18,"y":8},
		{"type":"coin","x":19,"y":8},
		{"type":"coin","x":20,"y":10},
		{"type":"coin","x":19,"y":10},
		{"type":"coin","x":23,"y":8},
		{"type":"coin","x":22,"y":8},
		{"type":"coin","x":23,"y":10},
		{"type":"coin","x":24,"y":10},
		{"type":"coin","x":26,"y":9},
		{"type":"coin","x":26,"y":10},
		{"type":"coin","x":24,"y":13},
		{"type":"coin","x":24,"y":12},
		{"type":"coin","x":26,"y":13},
		{"type":"coin","x":26,"y":14},
		{"type":"coin","x":24,"y":16},
		{"type":"coin","x":24,"y":17},
		{"type":"coin","x":25,"y":18},
		{"type":"coin","x":24,"y":19},
		{"type":"coin","x":22,"y":19},
		{"type":"coin","x":21,"y":20},
		{"type":"coin","x":21,"y":22},
		{"type":"coin","x":20,"y":23},
		{"type":"coin","x":18,"y":23},
		{"type":"coin","x":17,"y":24},
		{"type":"coin","x":16,"y":26},
		{"type":"coin","x":15,"y":26},
		{"type":"coin","x":15,"y":24},
		{"type":"coin","x":14,"y":24},
		{"type":"coin","x":12,"y":26},
		{"type":"coin","x":11,"y":26},
		{"type":"coin","x":11,"y":24},
		{"type":"coin","x":10,"y":24},
		{"type":"coin","x":8,"y":25},
		{"type":"coin","x":8,"y":24},
		{"type":"coin","x":10,"y":22},
		{"type":"coin","x":10,"y":21},
		{"type":"coin","x":8,"y":22},
		{"type":"coin","x":7,"y":22},
		{"type":"coin","x":7,"y":20},
		{"type":"coin","x":6,"y":20}
	]
}