{
	"name": "test stage",
	"icon": 23,
	"mark": 23,
	"wall1": 11,
	"wall2": 12,
	"bgmId": 4,

	"health": 9,
	"gravityPower": 0.1,
	"openStage": 24,
	"openStory": -1,
	"openPuppet": -1,

	"map": [
		[
			[1,1,1,1,1,1,1,1,1,1,1,1,1,1,1,1,1,1,1,1,1,1,1,1,1,1,1,1,1,1,1],
			[1,1,1,1,1,1,1,1,1,1,1,1,1,1,1,3,3,3,3,3,3,3,3,1,0,0,0,0,0,0,1],
			[1,1,1,1,1,1,1,1,1,1,1,1,1,3,1,0,1,0,1,0,1,0,1,0,0,0,0,0,0,0,1],
			[1,1,1,1,1,1,1,1,1,1,1,1,3,0,0,0,0,0,0,0,0,0,0,0,0,0,0,0,0,0,1],
			[1,1,1,1,1,1,1,1,1,1,1,3,1,0,0,0,0,0,0,0,0,0,0,0,0,0,0,0,0,0,1],
			[1,1,1,1,1,1,1,1,1,1,3,0,0,0,0,0,0,0,0,0,0,0,0,0,0,0,0,0,0,0,1],
			[1,1,1,1,1,1,1,1,1,3,1,0,0,0,1,0,1,0,1,0,1,0,0,0,0,0,0,0,0,0,1],
			[1,1,1,1,1,1,1,1,3,0,0,0,0,0,3,3,3,3,3,3,1,0,0,0,0,0,0,0,0,0,1],
			[1,1,1,1,1,1,1,1,1,0,0,0,1,3,1,1,1,1,1,1,1,1,1,1,1,1,1,1,1,1,1],
			[1,1,1,1,1,1,1,3,0,0,0,0,0,3,3,3,3,3,3,1,1,1,0,0,0,0,0,0,0,0,1],
			[1,1,1,1,1,1,1,3,1,0,0,0,1,0,1,0,1,0,1,0,1,0,0,0,0,0,0,0,0,0,1],
			[1,1,1,1,1,1,1,3,0,0,0,0,0,0,0,0,0,0,0,0,0,0,0,0,0,0,0,0,0,0,1],
			[1,1,1,1,1,1,1,3,1,0,0,0,0,0,0,0,0,0,0,0,0,0,0,0,0,0,0,0,0,0,1],
			[1,1,1,1,1,1,1,3,0,0,0,0,0,0,0,0,0,0,0,0,0,0,0,0,0,1,1,1,0,0,1],
			[1,1,1,1,1,1,1,3,1,0,1,0,1,0,1,0,1,0,0,0,0,0,0,0,1,0,0,1,0,0,1],
			[1,1,1,1,1,1,1,1,3,3,3,3,3,3,3,3,1,0,0,0,0,0,0,1,0,0,0,0,0,0,1],
			[1,1,1,1,1,1,3,1,0,1,0,1,0,1,0,1,0,0,0,0,0,0,0,1,0,0,1,0,0,1,1],
			[1,1,1,1,1,3,0,0,0,0,0,0,0,0,0,0,0,0,0,0,0,0,0,1,1,1,0,0,1,1,1],
			[1,1,1,1,3,1,0,0,0,0,0,0,0,0,0,0,0,0,0,0,0,0,0,0,0,0,0,1,1,1,1],
			[1,1,1,3,0,0,0,0,0,0,0,0,0,0,0,0,0,0,0,0,0,0,0,0,0,0,1,1,1,1,1],
			[1,1,3,1,0,0,0,1,0,1,0,1,0,1,0,1,0,0,0,0,0,0,0,0,0,1,1,1,1,1,1],
			[1,3,0,0,0,0,0,3,3,3,3,3,3,1,1,1,0,0,0,0,0,0,0,0,1,1,1,1,1,1,1],
			[1,1,0,0,0,1,3,1,1,1,1,1,1,1,1,1,1,1,1,1,1,1,1,1,1,1,1,1,1,1,1],
			[3,0,0,0,0,0,3,3,3,3,3,3,1,0,0,0,0,0,0,0,0,0,1,1,1,1,1,1,1,1,1],
			[3,1,0,0,0,1,0,1,0,1,0,1,0,0,0,0,0,0,0,0,0,1,1,1,1,1,1,1,1,1,1],
			[3,0,0,0,0,0,0,0,0,0,0,0,0,0,0,0,0,0,0,0,1,1,1,1,1,1,1,1,1,1,1],
			[3,1,0,0,0,0,0,0,0,0,0,0,0,0,0,0,0,0,0,1,1,1,1,1,1,1,1,1,1,1,1],
			[3,0,0,0,0,0,0,0,0,0,0,0,0,0,0,0,0,0,1,1,1,1,1,1,1,1,1,1,1,1,1],
			[3,1,0,1,0,1,0,1,0,1,0,0,0,0,0,0,0,1,1,1,1,1,1,1,1,1,1,1,1,1,1],
			[1,3,3,3,3,3,3,3,3,1,0,0,0,0,0,0,1,1,1,1,1,1,1,1,1,1,1,1,1,1,1],
			[1,1,1,1,1,1,1,1,1,1,1,1,1,1,1,1,1,1,1,1,1,1,1,1,1,1,1,1,1,1,1]
		],
		[
			[1,1,1,1,1,1,1,1,1,1,1,1,1,1,1,1,1,1,1,1,1,1,1,1,1,1,1,1,1,1,1],
			[1,1,1,1,1,1,1,1,1,1,1,1,1,1,1,1,1,1,1,1,1,1,1,1,0,0,0,0,0,0,1],
			[1,1,1,1,1,1,1,1,1,1,1,1,1,1,1,1,1,1,1,1,1,1,1,0,0,0,0,0,0,0,1],
			[1,1,1,1,1,1,1,1,1,1,1,1,1,1,1,1,1,1,1,1,1,1,0,0,0,0,0,0,0,0,1],
			[1,1,1,1,1,1,1,1,1,1,1,1,1,1,1,1,1,1,1,1,1,0,0,0,0,0,0,0,0,0,1],
			[1,1,1,1,1,1,1,1,1,1,1,1,1,1,1,1,1,1,1,1,1,0,0,0,0,0,0,0,0,0,1],
			[1,1,1,1,1,1,1,1,1,1,1,1,1,1,1,1,1,1,1,1,1,0,0,0,0,0,0,0,0,0,1],
			[1,1,1,1,1,1,1,1,1,1,1,1,1,1,1,1,1,1,1,1,1,0,0,0,0,0,0,0,0,0,1],
			[1,1,1,1,1,1,1,1,1,1,1,1,1,1,1,1,1,1,1,1,1,1,1,1,1,1,1,1,1,1,1],
			[1,1,1,1,1,1,1,1,1,1,1,1,1,1,1,1,1,1,1,1,1,1,0,0,0,0,0,0,0,0,1],
			[1,1,1,1,1,1,1,1,1,1,1,1,1,1,1,1,1,1,1,1,1,0,0,0,0,0,0,0,0,0,1],
			[1,1,1,1,1,1,1,1,1,1,1,1,1,1,1,1,1,1,1,1,0,0,0,0,0,0,0,0,0,0,1],
			[1,1,1,1,1,1,1,1,1,1,1,1,1,1,1,1,1,1,1,0,0,0,0,0,0,0,0,0,0,0,1],
			[1,1,1,1,1,1,1,1,1,1,1,1,1,1,1,1,1,1,0,0,0,0,0,0,0,1,1,1,0,0,1],
			[1,1,1,1,1,1,1,1,1,1,1,1,1,1,1,1,1,0,0,0,0,0,0,0,1,0,0,1,0,0,1],
			[1,1,1,1,1,1,1,1,1,1,1,1,1,1,1,1,1,0,0,0,0,0,0,1,0,0,0,0,0,0,1],
			[1,1,1,1,1,1,1,1,1,1,1,1,1,1,1,1,0,0,0,0,0,0,0,1,0,0,1,0,0,1,1],
			[1,1,1,1,1,1,1,1,1,1,1,1,1,1,1,1,0,0,0,0,0,0,0,1,1,1,0,0,1,1,1],
			[1,1,1,1,1,1,1,1,1,1,1,1,1,1,1,1,0,0,0,0,0,0,0,0,0,0,0,1,1,1,1],
			[1,1,1,1,1,1,1,1,1,1,1,1,1,1,1,1,0,0,0,0,0,0,0,0,0,0,1,1,1,1,1],
			[1,1,1,1,1,1,1,1,1,1,1,1,1,1,1,1,0,0,0,0,0,0,0,0,0,1,1,1,1,1,1],
			[1,1,1,1,1,1,1,1,1,1,1,1,1,1,1,1,0,0,0,0,0,0,0,0,1,1,1,1,1,1,1],
			[1,1,1,1,1,1,1,1,1,1,1,1,1,1,1,1,1,1,1,1,1,1,1,1,1,1,1,1,1,1,1],
			[1,1,1,1,1,1,1,1,1,1,1,1,1,0,0,0,0,0,0,0,0,0,1,1,1,1,1,1,1,1,1],
			[1,1,1,1,1,1,1,1,1,1,1,1,0,0,0,0,0,0,0,0,0,1,1,1,1,1,1,1,1,1,1],
			[1,1,1,1,1,1,1,1,1,1,1,0,0,0,0,0,0,0,0,0,1,1,1,1,1,1,1,1,1,1,1],
			[1,1,1,1,1,1,1,1,1,1,0,0,0,0,0,0,0,0,0,1,1,1,1,1,1,1,1,1,1,1,1],
			[1,1,1,1,1,1,1,1,1,1,0,0,0,0,0,0,0,0,1,1,1,1,1,1,1,1,1,1,1,1,1],
			[1,1,1,1,1,1,1,1,1,1,0,0,0,0,0,0,0,1,1,1,1,1,1,1,1,1,1,1,1,1,1],
			[1,1,1,1,1,1,1,1,1,1,0,0,0,0,0,0,1,1,1,1,1,1,1,1,1,1,1,1,1,1,1],
			[1,1,1,1,1,1,1,1,1,1,1,1,1,1,1,1,1,1,1,1,1,1,1,1,1,1,1,1,1,1,1]
		]
	],

	"player": [
		{"x":15,"y":26,"hp":100,"scale":5},
		{"x":13,"y":26,"hp":100},
		{"x":17,"y":26,"hp":100}
	],

	"enemy": [
		{"kind":"bone","x":23,"y":4,"mapIndex":1,"scale":8},
		{"kind":"armo","x":19,"y":15,"mapIndex":1,"scale":5},
		{"kind":"koro","x":19,"y":13,"mapIndex":1},
		{"kind":"koro","x":21,"y":13,"mapIndex":1},
		{"kind":"koro","x":17,"y":17,"mapIndex":1},
		{"kind":"koro","x":19,"y":17,"mapIndex":1}
	],

	"item": [
		{"type":"coin","x":8,"y":26},
		{"type":"coin","x":3,"y":22},
		{"type":"coin","x":4,"y":26},
		{"type":"coin","x":8,"y":18},
		{"type":"coin","x":12,"y":18},
		{"type":"coin","x":15,"y":12},
		{"type":"coin","x":11,"y":12},
		{"type":"coin","x":10,"y":8},
		{"type":"coin","x":15,"y":4},
		{"type":"coin","x":19,"y":4},
		{"type":"star","x":26,"y":4},
		{"type":"coin","x":24,"y":16},
		{"type":"coin","x":24,"y":15},
		{"type":"coin","x":25,"y":14},
		{"type":"coin","x":26,"y":14},
		{"type":"coin","x":26,"y":15},
		{"type":"coin","x":25,"y":15},
		{"type":"coin","x":25,"y":16},
		{"type":"coin","x":27,"y":12},
		{"type":"coin","x":24,"y":18},
		{"type":"coin","x":28,"y":13},
		{"type":"coin","x":28,"y":15},
		{"type":"coin","x":26,"y":17},
		{"type":"coin","x":24,"y":5},
		{"type":"coin","x":25,"y":3},
		{"type":"coin","x":27,"y":2},
		{"type":"coin","x":28,"y":3},
		{"type":"coin","x":27,"y":5},
		{"type":"coin","x":25,"y":6},
		{"type":"coin","x":17,"y":18},
		{"type":"coin","x":20,"y":12},
		{"type":"coin","x":22,"y":13},
		{"type":"coin","x":20,"y":17},
		{"type":"coin","x":19,"y":20},
		{"type":"coin","x":24,"y":10}
	]
}