{
	"name": "test stage",
	"icon": 9,
	"mark": 9,
	"wall1": 31,
	"wall2": 32,
	"bgmId": 2,

	"health": 9,
	"gravityPower": 0.1,
	"openStage": 10,
	"openStory": 3,
	"openPuppet": -1,

	"map": [
		[
			[1,1,1,1,1,1,1,1,1,1,1,1,1,1,1,1,1,1,1,1,1,1,1,1,1,1,1,1,1,1,1,1],
			[1,1,1,1,1,1,1,1,1,1,1,1,1,1,1,1,1,1,1,1,1,1,1,1,1,1,1,1,1,1,1,1],
			[1,1,1,1,1,1,1,1,1,1,1,1,1,1,1,1,1,1,1,1,1,1,1,1,1,1,1,1,1,1,1,1],
			[1,1,1,1,1,1,1,1,1,1,1,1,1,1,1,1,1,1,1,1,1,1,1,1,1,1,1,1,1,1,1,1],
			[1,1,1,1,1,1,1,1,1,1,1,1,1,1,1,1,1,1,1,1,1,1,0,0,1,1,1,1,1,1,1,1],
			[1,1,1,1,1,1,1,1,1,1,1,1,1,1,1,1,1,1,1,1,1,0,0,0,1,0,0,1,1,1,1,1],
			[1,1,1,1,1,1,1,1,1,1,1,1,1,1,1,1,1,1,1,1,1,0,0,1,0,1,0,1,1,1,1,1],
			[1,1,1,1,1,1,1,1,1,1,1,1,1,1,1,1,1,1,1,1,1,0,1,0,1,1,0,1,1,1,1,1],
			[1,1,1,1,1,1,1,1,1,1,1,1,1,1,1,1,1,1,1,1,0,1,0,1,1,0,0,1,1,1,1,1],
			[1,1,1,1,1,1,1,1,1,1,1,1,1,1,1,1,1,1,1,0,1,0,1,3,0,1,0,3,1,1,1,1],
			[1,1,1,1,1,1,1,1,1,1,1,1,1,1,1,1,1,1,1,0,0,1,1,0,0,0,0,1,1,1,1,1],
			[1,1,1,1,1,1,1,1,1,1,1,1,1,1,1,1,1,1,1,4,1,3,0,1,0,1,0,3,1,1,1,1],
			[1,1,1,1,1,1,1,1,1,1,1,1,1,1,1,1,1,1,0,1,1,0,2,0,0,0,0,1,1,1,1,1],
			[1,1,1,1,1,1,1,1,1,1,1,1,1,1,1,1,1,0,1,3,0,1,0,1,0,1,0,3,1,1,1,1],
			[1,1,1,1,1,1,1,1,1,1,1,1,1,1,1,1,0,1,1,0,0,0,0,0,2,0,0,1,1,1,1,1],
			[1,1,1,1,1,1,1,1,1,1,1,1,1,1,1,0,1,3,0,1,0,1,0,1,0,1,0,3,1,1,1,1],
			[1,1,1,1,1,1,1,1,1,1,1,1,1,1,0,1,1,0,0,2,0,0,0,0,0,0,0,1,1,1,1,1],
			[1,1,1,1,1,1,1,1,1,1,1,1,1,0,1,3,0,1,0,1,0,1,0,1,0,1,0,3,1,1,1,1],
			[1,1,1,1,1,1,1,1,1,1,1,1,0,1,1,0,0,0,0,0,0,0,0,2,0,0,0,1,1,1,1,1],
			[1,1,1,1,1,1,1,1,1,1,1,0,1,3,0,1,0,1,0,1,0,1,0,1,0,1,0,3,1,1,1,1],
			[1,1,1,1,1,1,1,1,1,1,0,1,1,0,0,0,0,0,0,0,0,0,0,0,0,0,0,1,1,1,1,1],
			[1,1,1,1,1,1,1,1,1,0,1,3,0,1,0,1,0,1,0,1,0,1,0,1,2,1,0,3,1,1,1,1],
			[1,1,1,1,1,1,1,1,0,1,1,0,0,2,0,0,0,0,0,0,0,0,0,0,0,0,0,1,1,1,1,1],
			[1,1,1,1,1,1,1,0,1,3,0,1,0,1,0,1,0,1,0,1,0,1,0,1,0,1,0,3,1,1,1,1],
			[1,1,1,1,1,1,0,1,1,0,0,0,0,0,0,0,0,0,2,0,0,0,0,0,0,0,0,1,1,1,1,1],
			[1,1,1,1,1,0,1,3,0,1,0,1,0,1,0,1,0,1,0,1,0,1,0,1,0,1,0,3,1,1,1,1],
			[1,1,1,1,0,1,1,0,0,0,0,0,0,0,0,0,0,0,0,0,0,0,0,0,0,0,0,1,1,1,1,1],
			[1,1,1,0,1,1,16,1,16,1,16,1,16,1,16,1,16,1,16,1,16,1,16,1,16,1,16,1,1,1,1,1],
			[1,1,4,1,1,0,1,0,1,0,1,0,1,0,1,0,1,0,1,0,1,0,1,0,1,0,1,1,1,1,1,1],
			[1,1,0,1,0,1,0,1,0,1,0,1,0,1,0,1,0,1,0,1,0,1,0,1,0,1,1,1,1,1,1,1],
			[1,1,8,12,12,12,12,12,12,12,12,12,12,12,12,12,12,12,12,12,12,12,12,12,1,1,1,1,1,1,1,1],
			[1,1,1,1,1,1,1,1,1,1,1,1,1,1,1,1,1,1,1,1,1,1,1,1,1,1,1,1,1,1,1,1]
		]
	],

	"player": [
		{"x":22,"y":5,"hp":100}
	],

	"enemy": [

	],

	"item": [
		{"type":"coin","x":5,"y":28},
		{"type":"coin","x":7,"y":28},
		{"type":"coin","x":9,"y":28},
		{"type":"star","x":11,"y":28},
		{"type":"coin","x":13,"y":28},
		{"type":"coin","x":15,"y":28},
		{"type":"coin","x":17,"y":28},
		{"type":"coin","x":19,"y":28},
		{"type":"coin","x":21,"y":28},
		{"type":"coin","x":23,"y":28},
		{"type":"coin","x":25,"y":28},
		{"type":"coin","x":21,"y":16},
		{"type":"coin","x":22,"y":16},
		{"type":"coin","x":22,"y":17},
		{"type":"coin","x":21,"y":18},
		{"type":"coin","x":20,"y":18},
		{"type":"coin","x":20,"y":17},
		{"type":"coin","x":16,"y":23},
		{"type":"coin","x":15,"y":24},
		{"type":"coin","x":14,"y":24},
		{"type":"coin","x":14,"y":23},
		{"type":"coin","x":15,"y":22},
		{"type":"coin","x":16,"y":22},
		{"type":"coin","x":20,"y":23},
		{"type":"coin","x":20,"y":24},
		{"type":"coin","x":21,"y":24},
		{"type":"coin","x":22,"y":23},
		{"type":"coin","x":22,"y":22},
		{"type":"coin","x":21,"y":22}
	]
}