{
	"name": "test stage",
	"icon": 20,
	"mark": 20,
	"wall1": 11,
	"wall2": 12,
	"bgmId": 4,

	"health": 9,
	"gravityPower": 0.1,
	"openStage": 21,
	"openStory": -1,
	"openPuppet": -1,

	"map": [
		[
			[1,1,1,1,1,1,1,1,1,1,1,1,1,1,1,1,1,1,1,1,1,1,1,1,1,1],
			[1,1,1,1,1,1,1,1,1,1,1,1,1,1,1,1,0,0,1,1,1,1,1,1,1,1],
			[1,1,1,1,1,1,1,1,1,1,1,1,0,0,1,0,1,0,1,1,1,1,1,1,1,1],
			[1,1,1,1,1,1,1,1,1,1,1,0,1,0,1,0,1,0,1,1,1,1,1,1,1,1],
			[1,1,1,1,1,1,1,0,0,1,1,0,1,0,1,0,1,0,1,1,1,1,1,1,1,1],
			[1,1,1,1,1,1,0,0,0,0,0,1,1,0,0,1,1,0,0,1,1,1,1,1,1,1],
			[1,1,1,1,1,1,0,0,1,1,1,1,1,1,1,1,0,0,0,1,1,1,1,1,1,1],
			[1,1,1,1,1,1,1,1,1,1,1,1,1,1,1,1,0,0,0,1,1,1,1,1,1,1],
			[1,1,1,1,1,1,1,1,1,1,1,1,1,1,1,1,0,0,1,1,1,1,1,1,1,1],
			[1,1,1,1,1,1,1,1,1,1,1,1,1,1,1,1,1,0,0,0,0,0,0,0,1,3],
			[1,1,1,1,1,1,1,1,1,1,1,1,1,1,1,1,0,0,0,0,0,0,0,0,0,3],
			[1,1,1,0,0,0,0,0,0,1,1,1,1,1,1,0,0,0,0,0,0,0,0,0,1,1],
			[1,1,1,1,1,1,1,0,0,1,1,1,1,1,0,0,0,0,0,0,0,0,0,0,1,1],
			[1,1,1,0,0,0,0,0,0,1,1,1,1,0,0,0,0,0,0,0,0,0,0,1,1,1],
			[1,1,1,1,1,1,1,0,0,1,1,1,1,0,0,0,0,0,0,0,0,0,1,1,1,1],
			[1,1,1,0,0,0,0,0,0,1,1,3,0,0,0,0,0,0,0,0,0,1,1,1,1,1],
			[1,1,1,1,1,1,1,0,0,1,1,3,1,0,0,0,0,0,0,0,1,1,1,1,1,1],
			[1,1,1,1,1,1,1,0,0,1,1,1,1,1,1,1,1,0,0,0,1,1,1,1,1,1],
			[1,1,1,1,1,1,0,0,0,1,1,1,1,1,1,1,1,0,0,0,1,1,1,1,1,1],
			[1,1,1,1,1,0,0,0,0,1,1,1,1,1,1,1,1,0,0,0,1,1,1,1,1,1],
			[1,1,1,1,0,0,0,0,0,1,1,3,3,1,1,1,1,0,0,0,1,1,1,1,1,1],
			[1,1,1,0,0,0,0,0,0,1,1,0,1,1,1,1,1,0,0,0,1,1,1,1,1,1],
			[1,1,0,0,0,0,0,0,0,0,0,0,0,0,0,0,0,0,0,0,1,1,1,1,1,1],
			[3,0,0,0,0,0,0,0,0,0,0,0,0,0,0,0,0,0,0,1,1,1,1,1,1,1],
			[3,1,1,1,1,1,1,1,1,1,1,1,1,0,1,1,1,1,1,1,1,1,1,1,1,1],
			[1,1,1,1,1,1,1,1,1,1,1,1,3,3,1,1,1,1,1,1,1,1,1,1,1,1]
		],
		[
			[1,1,1,1,1,1,1,1,1,1,1,1,1,1,1,1,1,1,1,1,1,1,1,1,1,1],
			[1,1,1,1,1,1,1,1,1,1,1,1,1,1,1,1,1,1,1,1,1,1,1,1,1,1],
			[1,1,1,1,1,1,1,1,1,1,1,1,1,1,1,1,1,1,1,1,1,1,1,1,1,1],
			[1,1,1,1,1,1,1,1,1,1,1,1,1,1,1,1,1,1,1,1,1,1,1,1,1,1],
			[1,1,1,1,1,1,1,1,1,1,1,1,1,1,1,1,1,1,1,1,1,1,1,1,1,1],
			[1,1,1,1,1,1,1,1,1,1,1,1,1,1,1,1,1,1,1,1,1,1,1,1,1,1],
			[1,1,1,1,1,1,1,1,1,1,1,1,1,1,1,1,1,1,1,1,1,1,1,1,1,1],
			[1,1,1,1,1,1,1,1,1,1,1,1,1,1,1,1,1,1,1,1,1,1,1,1,1,1],
			[1,1,1,1,1,1,1,1,1,1,1,1,1,1,1,1,1,1,1,1,1,1,1,1,1,1],
			[1,1,1,1,1,1,1,1,1,1,1,1,1,1,1,1,1,0,0,0,0,0,0,0,1,1],
			[1,1,1,1,1,1,1,1,1,1,1,1,1,1,1,1,0,0,0,0,0,0,0,0,1,1],
			[1,1,1,1,1,1,1,1,1,1,1,1,1,1,1,0,0,0,0,0,0,0,0,0,1,1],
			[1,1,1,1,1,1,1,1,1,1,1,1,1,1,0,0,0,0,0,0,0,0,0,0,1,1],
			[1,1,1,1,1,1,1,1,1,1,1,1,1,0,0,0,0,0,0,0,0,0,0,1,1,1],
			[1,1,1,1,1,1,1,1,1,1,1,1,1,0,0,0,0,0,0,0,0,0,1,1,1,1],
			[1,1,1,1,1,1,1,1,1,1,1,1,1,0,0,0,0,0,0,0,0,1,1,1,1,1],
			[1,1,1,1,1,1,1,1,0,1,1,1,1,0,0,0,0,0,0,0,1,1,1,1,1,1],
			[1,1,1,1,1,1,1,0,0,1,1,1,1,1,1,1,1,1,1,1,1,1,1,1,1,1],
			[1,1,1,1,1,1,0,0,0,1,1,1,1,1,1,1,1,1,1,1,1,1,1,1,1,1],
			[1,1,1,1,1,0,0,0,0,1,1,1,1,1,1,1,1,1,1,1,1,1,1,1,1,1],
			[1,1,1,1,0,0,0,0,0,1,1,1,1,1,1,1,1,1,1,1,1,1,1,1,1,1],
			[1,1,1,0,0,0,0,0,0,1,1,1,1,1,1,1,1,1,1,1,1,1,1,1,1,1],
			[1,1,0,0,0,0,0,0,0,1,1,1,1,1,1,1,1,1,1,1,1,1,1,1,1,1],
			[1,0,0,0,0,0,0,0,0,1,1,1,1,1,1,1,1,1,1,1,1,1,1,1,1,1],
			[1,1,1,1,1,1,1,1,1,1,1,1,1,1,1,1,1,1,1,1,1,1,1,1,1,1],
			[1,1,1,1,1,1,1,1,1,1,1,1,1,1,1,1,1,1,1,1,1,1,1,1,1,1]
		]
	],

	"player": [
		{"x":3,"y":11,"hp":100},
		{"x":4,"y":11,"hp":100},
		{"x":5,"y":11,"hp":100},
		{"x":3,"y":13,"hp":100},
		{"x":4,"y":13,"hp":100},
		{"x":5,"y":13,"hp":100},
		{"x":3,"y":15,"hp":100},
		{"x":4,"y":15,"hp":100},
		{"x":5,"y":15,"hp":100}
	],

	"enemy": [
		{"kind":"koro","x":7,"y":18,"mapIndex":1},
		{"kind":"koro","x":3,"y":22,"mapIndex":1},
		{"kind":"koro","x":7,"y":22,"mapIndex":1},
		{"kind":"bone","x":14,"y":15,"mapIndex":1},
		{"kind":"bone","x":22,"y":10,"mapIndex":1},
		{"kind":"bone","x":22,"y":12,"mapIndex":1},
		{"kind":"bone","x":14,"y":13,"mapIndex":1},
		{"kind":"bone","x":16,"y":13,"mapIndex":1},
		{"kind":"bone","x":20,"y":12,"mapIndex":1},
		{"kind":"bone","x":18,"y":11,"mapIndex":1},
		{"kind":"bone","x":18,"y":14,"mapIndex":1},
		{"kind":"koro","x":16,"y":11,"mapIndex":1},
		{"kind":"koro","x":16,"y":15,"mapIndex":1},
		{"kind":"koro","x":20,"y":10,"mapIndex":1},
		{"kind":"koro","x":20,"y":14,"mapIndex":1},
		{"kind":"koro","x":17,"y":11,"mapIndex":1},
		{"kind":"koro","x":19,"y":11,"mapIndex":1},
		{"kind":"koro","x":17,"y":14,"mapIndex":1},
		{"kind":"koro","x":19,"y":14,"mapIndex":1}
	],

	"item": [
		{"type":"star","x":7,"y":5},
		{"type":"coin","x":5,"y":20},
		{"type":"coin","x":6,"y":20},
		{"type":"coin","x":7,"y":20},
		{"type":"coin","x":6,"y":21},
		{"type":"coin","x":5,"y":21},
		{"type":"coin","x":5,"y":22},
		{"type":"coin","x":9,"y":23},
		{"type":"coin","x":11,"y":23},
		{"type":"coin","x":13,"y":22},
		{"type":"coin","x":15,"y":22},
		{"type":"coin","x":18,"y":18},
		{"type":"coin","x":18,"y":20},
		{"type":"coin","x":18,"y":22},
		{"type":"coin","x":17,"y":6},
		{"type":"coin","x":17,"y":8},
		{"type":"coin","x":15,"y":13},
		{"type":"coin","x":14,"y":14},
		{"type":"coin","x":15,"y":14},
		{"type":"coin","x":21,"y":11},
		{"type":"coin","x":22,"y":11},
		{"type":"coin","x":21,"y":12},
		{"type":"coin","x":18,"y":12},
		{"type":"coin","x":18,"y":13}
	]
}