{
	"name": "test stage",
	"icon": 21,
	"mark": 21,
	"wall1": 11,
	"wall2": 12,
	"bgmId": 4,

	"health": 9,
	"gravityPower": 0.1,
	"openStage": 22,
	"openStory": -1,
	"openPuppet": -1,

	"map": [
		[
			[1,1,1,1,1,1,1,1,1,1,1,1,1,1,1,1,1,1,1,1,1,1,1,1,1,1,1,1,1,1,1,1],
			[1,1,1,1,1,1,1,1,1,1,1,1,1,1,1,1,1,1,1,1,1,1,1,1,1,1,1,1,1,1,1,1],
			[1,1,1,1,1,1,1,1,1,1,1,1,1,1,1,1,1,1,1,1,1,1,1,1,1,1,1,1,1,1,1,1],
			[1,1,1,1,1,1,1,1,1,1,1,1,1,1,1,3,3,1,1,1,1,1,1,0,0,0,0,0,1,1,1,1],
			[1,1,1,1,1,1,1,1,1,1,1,1,1,1,1,0,0,1,1,1,1,1,0,1,1,1,0,0,1,1,1,1],
			[1,1,1,1,1,1,0,1,0,0,0,0,0,0,1,0,0,1,1,1,1,0,1,1,1,0,0,0,1,1,1,1],
			[1,1,1,1,1,1,0,20,1,1,1,2,1,0,1,0,0,1,1,1,0,1,1,1,0,0,0,0,1,1,1,1],
			[1,1,1,1,1,1,0,0,0,0,1,1,0,1,1,0,0,1,1,0,0,0,0,0,0,0,0,0,1,1,1,1],
			[1,1,1,1,1,1,0,20,1,0,0,1,0,0,1,0,0,1,1,0,0,0,0,0,0,0,0,1,1,1,1,1],
			[1,1,1,1,1,1,0,0,1,1,0,1,1,0,1,0,0,1,1,0,0,0,0,0,0,0,1,1,1,1,1,1],
			[1,1,1,1,1,1,0,0,1,0,1,1,0,1,1,0,0,1,1,0,0,0,0,0,0,1,1,1,1,1,1,1],
			[1,1,1,1,1,1,0,0,1,0,0,1,0,0,1,0,0,1,1,0,0,0,0,0,0,0,0,0,0,2,1,1],
			[1,1,1,1,1,1,0,0,1,1,0,1,1,0,1,0,0,1,1,1,1,1,1,1,1,1,1,0,1,1,1,1],
			[1,1,1,1,1,1,0,0,1,0,1,1,0,1,1,0,0,1,1,2,0,0,0,0,0,0,0,0,2,1,1,1],
			[1,1,1,1,1,1,0,0,1,0,0,1,0,0,1,0,0,1,1,1,0,1,1,1,1,1,1,1,1,1,1,1],
			[1,1,1,1,1,1,0,0,1,1,0,1,1,0,1,0,0,1,2,0,0,0,0,0,0,0,0,2,1,1,1,1],
			[1,1,1,1,1,1,0,0,1,0,1,1,0,1,1,0,0,1,1,1,1,1,1,1,1,0,1,1,1,1,1,1],
			[1,1,1,1,1,1,0,0,1,0,0,1,0,0,1,0,0,1,1,2,0,0,0,0,0,0,2,1,1,1,1,1],
			[1,1,1,1,1,1,0,0,1,1,0,1,1,0,0,0,0,1,1,1,0,1,1,1,1,1,1,1,1,1,1,1],
			[1,1,1,1,1,1,0,0,1,0,1,0,1,1,1,8,0,1,2,0,0,0,0,0,0,0,0,0,1,1,1,1],
			[1,1,1,1,1,1,0,0,1,0,1,0,0,0,0,1,0,1,1,1,1,1,1,1,1,1,1,0,1,1,1,1],
			[1,1,1,1,1,1,0,0,1,0,1,0,1,1,1,1,1,1,1,1,1,0,0,0,1,1,0,0,1,1,1,1],
			[1,1,1,1,1,1,3,3,1,0,1,1,0,0,0,0,0,0,0,1,0,0,0,0,1,0,0,0,1,1,1,1],
			[1,1,1,1,1,1,1,1,0,0,0,1,1,1,0,0,1,1,1,0,1,1,1,1,0,0,0,0,1,1,1,1],
			[1,1,1,1,1,1,0,0,0,0,0,0,0,0,0,0,0,1,0,0,0,0,0,0,0,0,0,0,1,1,1,1],
			[1,1,1,1,1,0,0,0,0,0,0,0,1,0,0,1,1,1,0,1,1,1,1,0,0,0,0,1,1,1,1,1],
			[1,1,1,1,0,0,0,0,0,0,0,1,0,0,0,0,0,0,0,0,0,0,1,0,0,0,1,1,1,1,1,1],
			[1,1,1,1,1,1,1,1,1,1,1,0,0,0,1,1,1,1,0,0,0,1,1,0,0,1,1,1,1,1,1,1],
			[1,1,1,0,0,0,0,0,0,0,0,0,0,0,0,0,1,1,1,1,1,1,1,0,1,1,1,1,1,1,1,1],
			[1,1,1,1,1,1,1,1,1,1,1,1,1,1,1,1,1,1,1,1,1,1,1,1,1,1,1,1,1,1,1,1],
			[1,1,1,1,1,1,1,1,1,1,1,1,1,1,1,1,1,1,1,1,1,1,1,1,1,1,1,1,1,1,1,1],
			[1,1,1,1,1,1,1,1,1,1,1,1,1,1,1,1,1,1,1,1,1,1,1,1,1,1,1,1,1,1,1,1]
		],
		[
			[1,1,1,1,1,1,1,1,1,1,1,1,1,1,1,1,1,1,1,1,1,1,1,1,1,1,1,1,1,1,1,1],
			[1,1,1,1,1,1,1,1,1,1,1,1,1,1,1,1,1,1,1,1,1,1,1,1,1,1,1,1,1,1,1,1],
			[1,1,1,1,1,1,1,1,1,1,1,1,1,1,1,1,1,1,1,1,1,1,1,1,1,1,1,1,1,1,1,1],
			[1,1,1,1,1,1,1,1,1,1,1,1,1,1,1,3,3,1,1,1,1,1,1,0,0,0,0,0,1,1,1,1],
			[1,1,1,1,1,1,1,1,1,1,1,1,1,1,1,0,0,1,1,1,1,1,0,1,1,1,0,0,1,1,1,1],
			[1,1,1,1,1,1,0,1,1,1,1,1,1,1,1,0,0,1,1,1,1,0,1,1,1,0,0,0,1,1,1,1],
			[1,1,1,1,1,1,0,20,1,1,1,1,1,1,1,0,0,1,1,1,0,1,1,1,0,0,0,0,1,1,1,1],
			[1,1,1,1,1,1,0,0,1,1,1,1,1,1,1,0,0,1,1,0,0,0,0,0,0,0,0,0,1,1,1,1],
			[1,1,1,1,1,1,0,20,1,1,1,1,1,1,1,0,0,1,1,0,0,0,0,0,0,0,0,1,1,1,1,1],
			[1,1,1,1,1,1,0,0,1,1,1,1,1,1,1,0,0,1,1,0,0,0,0,0,0,0,1,1,1,1,1,1],
			[1,1,1,1,1,1,0,0,1,1,1,1,1,1,1,0,0,1,1,0,0,0,0,0,0,1,1,1,1,1,1,1],
			[1,1,1,1,1,1,0,0,1,1,1,1,1,1,1,0,0,1,1,0,0,0,0,0,1,1,1,1,1,1,1,1],
			[1,1,1,1,1,1,0,0,1,1,1,1,1,1,1,0,0,1,1,1,1,1,1,1,1,1,1,1,1,1,1,1],
			[1,1,1,1,1,1,0,0,1,1,1,1,1,1,1,0,0,1,1,1,1,1,1,1,1,1,1,1,1,1,1,1],
			[1,1,1,1,1,1,0,0,1,1,1,1,1,1,1,0,0,1,1,1,1,1,1,1,1,1,1,1,1,1,1,1],
			[1,1,1,1,1,1,0,0,1,1,1,1,1,1,1,0,0,1,1,1,1,1,1,1,1,1,1,1,1,1,1,1],
			[1,1,1,1,1,1,0,0,1,1,1,1,1,1,1,0,0,1,1,1,1,1,1,1,1,1,1,1,1,1,1,1],
			[1,1,1,1,1,1,0,0,1,1,1,1,1,1,1,0,0,1,1,1,1,1,1,1,1,1,1,1,1,1,1,1],
			[1,1,1,1,1,1,0,0,1,1,1,1,1,1,1,0,0,1,1,1,1,1,1,1,1,1,1,1,1,1,1,1],
			[1,1,1,1,1,1,0,0,1,1,1,1,1,1,1,8,0,1,1,1,1,1,1,1,1,1,1,1,1,1,1,1],
			[1,1,1,1,1,1,0,0,1,1,1,1,1,1,1,1,0,1,1,1,1,1,1,1,1,1,1,0,1,1,1,1],
			[1,1,1,1,1,1,0,0,1,1,1,1,1,1,1,1,1,1,1,1,1,1,1,1,1,1,0,0,1,1,1,1],
			[1,1,1,1,1,1,3,3,1,1,1,1,1,1,0,0,0,1,1,1,1,1,1,1,1,0,0,0,1,1,1,1],
			[1,1,1,1,1,1,1,1,0,0,0,1,1,1,0,0,1,1,1,1,1,1,1,1,0,0,0,0,1,1,1,1],
			[1,1,1,1,1,1,0,0,0,0,0,0,1,0,0,0,0,1,1,1,1,1,1,0,0,0,0,0,1,1,1,1],
			[1,1,1,1,1,0,0,0,0,0,0,0,1,0,0,1,1,1,1,1,1,1,1,0,0,0,0,1,1,1,1,1],
			[1,1,1,1,0,0,0,0,0,0,0,1,0,0,0,1,1,1,1,1,1,1,1,0,0,0,1,1,1,1,1,1],
			[1,1,1,1,1,1,1,1,1,1,1,0,0,0,1,1,1,1,1,1,1,1,1,0,0,1,1,1,1,1,1,1],
			[1,1,1,1,1,1,1,1,1,1,0,0,0,0,1,1,1,1,1,1,1,1,1,0,1,1,1,1,1,1,1,1],
			[1,1,1,1,1,1,1,1,1,1,1,1,1,1,1,1,1,1,1,1,1,1,1,1,1,1,1,1,1,1,1,1],
			[1,1,1,1,1,1,1,1,1,1,1,1,1,1,1,1,1,1,1,1,1,1,1,1,1,1,1,1,1,1,1,1],
			[1,1,1,1,1,1,1,1,1,1,1,1,1,1,1,1,1,1,1,1,1,1,1,1,1,1,1,1,1,1,1,1]
		]
	],

	"player": [
		{"x":11,"y":19,"hp":100}
	],

	"enemy": [
		{"kind":"armo","x":21,"y":9,"mapIndex":1},
		{"kind":"armo","x":25,"y":7,"mapIndex":1},
		{"kind":"koro","x":16,"y":8,"mapIndex":1},
		{"kind":"koro","x":6,"y":14,"mapIndex":1},
		{"kind":"bone","x":7,"y":25,"mapIndex":1},
		{"kind":"bone","x":9,"y":25,"mapIndex":1},
		{"kind":"armo","x":14,"y":24,"mapIndex":1},
		{"kind":"armo","x":12,"y":27,"mapIndex":1},
		{"kind":"bone","x":25,"y":24,"mapIndex":1}
	],

	"item": [
		{"type":"star","x":23,"y":8},
		{"type":"coin","x":22,"y":8},
		{"type":"coin","x":22,"y":9},
		{"type":"coin","x":23,"y":9},
		{"type":"coin","x":24,"y":8},
		{"type":"coin","x":24,"y":7},
		{"type":"coin","x":23,"y":7},
		{"type":"coin","x":27,"y":12},
		{"type":"coin","x":20,"y":14},
		{"type":"coin","x":20,"y":18},
		{"type":"coin","x":25,"y":23},
		{"type":"coin","x":26,"y":22},
		{"type":"coin","x":26,"y":23},
		{"type":"coin","x":26,"y":24},
		{"type":"coin","x":25,"y":25},
		{"type":"coin","x":24,"y":24},
		{"type":"coin","x":24,"y":25},
		{"type":"coin","x":24,"y":26},
		{"type":"coin","x":22,"y":22},
		{"type":"coin","x":21,"y":22},
		{"type":"coin","x":20,"y":26},
		{"type":"coin","x":19,"y":26},
		{"type":"coin","x":15,"y":28},
		{"type":"coin","x":16,"y":24},
		{"type":"coin","x":18,"y":22},
		{"type":"coin","x":12,"y":22},
		{"type":"coin","x":3,"y":28},
		{"type":"coin","x":4,"y":28},
		{"type":"coin","x":5,"y":28},
		{"type":"coin","x":6,"y":25},
		{"type":"coin","x":8,"y":25},
		{"type":"coin","x":10,"y":25},
		{"type":"coin","x":15,"y":6},
		{"type":"coin","x":15,"y":10},
		{"type":"coin","x":15,"y":14},
		{"type":"coin","x":7,"y":11},
		{"type":"coin","x":7,"y":15},
		{"type":"coin","x":7,"y":19}
	]
}