{
	"name": "test stage",
	"icon": 6,
	"mark": 6,
	"wall1": 31,
	"wall2": 32,
	"bgmId": 2,

	"health": 9,
	"gravityPower": 0.1,
	"openStage": 7,
	"openStory": -1,
	"openPuppet": -1,

	"map": [
		[
			[1,1,1,1,1,1,1,1,1,1,1,1,1,1,1,1,1,1,1,1,1,1,1,1,1,1,1,1,1,1,1,1],
			[1,1,1,1,1,1,1,1,1,1,1,1,1,1,1,1,1,1,1,1,1,1,1,1,1,1,1,1,1,1,1,1],
			[1,1,1,1,1,1,0,1,1,1,1,1,1,1,1,1,1,1,1,1,1,0,1,1,1,1,1,1,1,1,1,1],
			[1,1,1,1,1,0,0,0,1,1,1,1,1,1,1,0,1,0,1,1,0,1,0,1,1,0,0,1,1,1,1,1],
			[1,1,1,1,1,0,0,0,0,0,0,0,1,0,1,0,1,1,1,1,1,0,1,1,0,0,1,0,0,1,1,1],
			[1,1,1,1,0,1,1,1,3,0,1,0,0,0,0,0,0,1,0,0,0,1,1,1,0,1,1,0,0,1,1,1],
			[1,1,1,0,1,1,1,1,1,1,1,1,1,0,0,0,1,1,1,0,0,0,0,0,1,1,0,0,1,1,1,1],
			[1,1,0,1,1,1,1,0,0,0,1,0,0,0,0,0,0,0,0,0,0,2,1,0,0,0,1,0,0,1,1,1],
			[1,1,1,0,0,0,1,1,1,0,1,1,0,1,0,1,0,0,0,1,1,1,0,1,1,1,0,1,1,1,1,1],
			[1,1,1,1,1,0,1,1,1,1,1,1,1,1,0,0,0,1,0,1,1,0,1,1,1,0,0,1,1,1,1,1],
			[1,1,1,1,0,0,0,0,1,0,0,1,1,0,0,0,0,0,1,0,0,1,1,1,2,0,1,1,1,1,1,1],
			[1,1,1,1,1,1,0,0,0,0,0,0,0,0,2,0,0,0,0,0,1,1,0,1,0,0,1,1,1,1,1,1],
			[1,1,1,1,1,1,3,0,1,1,0,0,0,0,0,0,1,1,0,0,0,0,0,0,0,0,1,1,1,1,1,1],
			[1,1,1,0,0,1,1,0,0,0,0,0,0,1,0,3,1,0,0,0,0,1,0,0,0,1,1,1,1,1,1,1],
			[1,1,1,1,1,0,0,1,0,0,0,1,0,0,0,0,1,0,1,1,0,1,0,1,0,0,0,1,1,1,1,1],
			[1,1,1,1,1,0,1,1,1,2,0,0,0,0,0,0,0,1,2,0,1,1,1,1,0,1,1,1,1,1,1,1],
			[1,1,1,1,1,0,0,0,1,0,0,0,1,0,0,0,1,0,1,0,0,0,0,0,0,1,1,1,1,1,1,1],
			[1,1,1,1,0,1,0,1,0,0,0,0,0,2,0,1,0,0,0,0,1,0,1,0,1,0,0,1,1,1,1,1],
			[1,1,1,1,0,0,0,0,0,1,0,0,0,0,0,0,0,0,0,0,0,0,1,0,1,0,1,1,1,1,1,1],
			[1,1,1,1,1,0,0,0,0,1,0,0,0,1,0,0,0,0,0,0,0,0,0,1,1,0,1,1,1,1,1,1],
			[1,1,1,0,0,0,0,0,0,1,0,1,1,0,0,1,0,0,1,1,0,1,0,1,0,0,1,1,1,1,1,1],
			[1,1,1,0,1,1,0,0,1,2,0,1,0,0,0,3,0,0,0,0,1,0,3,0,0,0,1,1,1,1,1,1],
			[1,1,1,1,1,1,3,0,0,0,0,0,1,0,0,0,1,0,3,0,1,0,0,1,1,1,1,1,1,1,1,1],
			[1,1,1,1,1,1,1,1,1,0,3,1,0,1,1,0,1,1,1,0,1,1,0,1,0,1,1,1,1,1,1,1],
			[1,1,1,1,1,1,1,1,0,0,1,0,1,0,0,1,1,1,1,1,1,0,1,1,1,1,1,1,1,1,1,1],
			[1,1,1,1,1,1,0,0,0,1,1,1,0,1,0,0,0,0,0,0,0,0,0,1,1,0,1,1,1,1,1,1],
			[1,1,1,1,1,0,0,0,1,1,1,1,0,0,0,1,1,1,1,0,0,0,0,1,1,0,1,1,1,1,1,1],
			[1,1,1,1,0,1,0,1,0,1,1,0,0,3,0,0,1,0,1,0,0,1,0,0,0,1,1,1,1,1,1,1],
			[1,1,1,1,0,0,0,1,1,1,1,1,1,1,1,1,1,0,1,0,1,1,1,1,1,1,1,1,1,1,1,1],
			[1,1,1,1,0,1,1,1,1,1,1,1,1,1,1,1,1,0,0,1,1,1,1,1,1,1,1,1,1,1,1,1],
			[1,1,1,1,1,1,1,1,1,1,1,1,1,1,1,1,1,1,1,1,1,1,1,1,1,1,1,1,1,1,1,1],
			[1,1,1,1,1,1,1,1,1,1,1,1,1,1,1,1,1,1,1,1,1,1,1,1,1,1,1,1,1,1,1,1]
		]
	],

	"player": [
		{"x":15,"y":3,"hp":100}
	],

	"enemy": [
		{"kind":"koro","x":10,"y":11},
		{"kind":"koro","x":23,"y":13},
		{"kind":"koro","x":11,"y":19},
		{"kind":"bone","x":13,"y":6},
		{"kind":"bone","x":24,"y":20},
		{"kind":"armo","x":8,"y":24}
	],

	"item": [
		{"type":"star","x":20,"y":26},
		{"type":"coin","x":6,"y":3},
		{"type":"coin","x":6,"y":2},
		{"type":"coin","x":5,"y":3},
		{"type":"coin","x":6,"y":4},
		{"type":"coin","x":7,"y":3},
		{"type":"coin","x":5,"y":4},
		{"type":"coin","x":6,"y":18},
		{"type":"coin","x":6,"y":19},
		{"type":"coin","x":5,"y":19},
		{"type":"coin","x":5,"y":20},
		{"type":"coin","x":6,"y":20},
		{"type":"coin","x":7,"y":19},
		{"type":"coin","x":7,"y":18},
		{"type":"coin","x":17,"y":18},
		{"type":"coin","x":18,"y":17},
		{"type":"coin","x":19,"y":17},
		{"type":"coin","x":18,"y":19},
		{"type":"coin","x":17,"y":19},
		{"type":"coin","x":19,"y":18},
		{"type":"coin","x":18,"y":18},
		{"type":"coin","x":20,"y":27},
		{"type":"coin","x":19,"y":27},
		{"type":"coin","x":19,"y":26},
		{"type":"coin","x":20,"y":25},
		{"type":"coin","x":21,"y":25},
		{"type":"coin","x":21,"y":26},
		{"type":"coin","x":12,"y":11},
		{"type":"coin","x":13,"y":11},
		{"type":"coin","x":13,"y":12},
		{"type":"coin","x":12,"y":13},
		{"type":"coin","x":11,"y":13},
		{"type":"coin","x":12,"y":12},
		{"type":"coin","x":11,"y":12},
		{"type":"coin","x":27,"y":5},
		{"type":"coin","x":5,"y":28},
		{"type":"coin","x":5,"y":10},
		{"type":"coin","x":26,"y":14},
		{"type":"coin","x":25,"y":25},
		{"type":"coin","x":20,"y":12},
		{"type":"coin","x":14,"y":6}
	]
}