{
	"name": "test stage",
	"icon": 15,
	"mark": 15,
	"wall1": 21,
	"wall2": 22,
	"bgmId": 3,

	"health": 9,
	"gravityPower": 0.1,
	"openStage": 16,
	"openStory": -1,
	"openPuppet": -1,

	"map": [
		[
			[1,1,1,1,1,1,1,1,1,1,1,1,1,1,1,1,1,1,1,1,1,1,1,1,1,1,1,1,1,1,1,1],
			[1,1,1,1,1,1,1,1,1,1,1,1,1,1,1,1,1,1,1,1,1,1,1,1,1,1,1,1,1,1,1,1],
			[1,1,1,1,1,1,1,1,1,1,1,1,1,1,1,1,1,1,1,1,1,1,1,1,1,1,1,1,1,1,1,1],
			[1,1,1,1,1,1,1,1,1,1,1,1,1,1,1,1,1,1,1,1,1,1,1,1,1,1,1,1,1,1,1,1],
			[1,1,1,1,1,1,1,1,1,1,1,1,1,1,1,1,1,1,1,1,1,1,1,1,1,1,1,1,1,1,1,1],
			[1,1,1,1,1,1,1,1,1,1,1,1,1,1,1,1,1,1,1,1,1,1,1,1,1,1,1,1,1,1,1,1],
			[1,1,1,1,1,1,1,1,1,1,1,1,1,1,1,1,1,1,1,1,1,1,1,1,1,1,1,1,1,1,1,1],
			[1,1,1,1,1,1,1,1,1,1,1,1,0,0,0,0,1,1,0,0,0,0,1,1,0,0,0,0,1,1,1,1],
			[1,1,1,1,1,1,1,1,1,1,1,0,0,1,0,0,1,0,0,1,0,0,1,0,0,1,0,0,1,1,1,1],
			[1,1,1,1,1,1,1,0,0,0,0,0,0,1,0,0,0,0,1,1,0,0,0,0,1,0,0,0,0,0,0,1],
			[1,1,1,1,1,1,1,1,0,1,1,1,1,1,1,1,1,1,1,1,1,1,1,1,1,1,1,1,0,1,1,1],
			[1,1,1,1,1,1,0,0,0,0,0,0,0,1,1,1,1,1,1,1,1,20,20,20,20,1,1,0,0,0,1,1],
			[1,1,1,1,1,1,1,1,1,1,0,1,1,1,1,1,1,1,1,1,1,0,0,0,0,1,0,0,0,1,1,1],
			[1,1,1,1,1,0,0,0,0,0,0,0,1,1,1,1,1,0,0,1,1,0,0,0,0,0,1,1,1,1,1,1],
			[1,1,1,1,1,1,0,1,1,1,1,1,3,1,1,1,0,0,0,1,1,0,0,0,0,1,1,1,1,1,1,1],
			[1,1,1,1,1,0,1,0,0,0,0,0,1,1,1,1,0,0,1,1,1,0,0,0,0,1,1,1,1,1,1,1],
			[1,1,1,1,0,1,0,1,1,1,1,0,1,1,1,3,0,3,1,1,1,0,0,0,0,1,1,1,1,1,1,1],
			[1,1,1,0,1,0,1,0,0,0,1,0,1,1,1,0,0,1,1,1,1,0,0,0,0,1,1,1,1,1,1,1],
			[1,1,0,1,0,3,0,1,1,0,1,0,1,1,3,0,3,1,1,1,1,0,0,0,0,1,1,1,1,1,1,1],
			[1,1,0,1,0,1,0,0,3,0,1,0,1,1,0,0,1,1,1,1,1,0,0,0,0,1,1,1,1,1,1,1],
			[1,1,0,1,0,1,1,0,1,0,1,0,1,3,0,3,1,1,1,1,1,0,0,0,0,1,1,1,1,1,1,1],
			[1,1,0,1,0,0,0,1,0,1,0,1,1,0,0,1,1,1,1,1,1,0,0,0,0,1,1,1,1,1,1,1],
			[1,1,0,1,1,1,1,0,1,0,1,1,1,0,1,1,1,1,1,1,1,0,0,0,0,1,1,1,1,1,1,1],
			[1,1,0,0,0,0,0,1,0,1,1,1,0,0,1,1,1,1,1,1,1,0,0,0,0,1,1,1,1,1,1,1],
			[1,3,1,1,1,1,1,0,1,1,1,1,0,1,1,1,1,1,1,1,1,0,0,0,0,1,1,1,1,1,1,1],
			[1,1,1,1,1,1,0,1,1,2,0,0,1,1,1,1,1,1,1,1,1,0,0,0,0,1,1,1,1,1,1,1],
			[1,1,1,1,1,1,0,1,0,0,0,1,1,1,1,1,1,1,1,1,1,0,0,0,0,1,1,1,1,1,1,1],
			[1,1,1,1,1,1,0,0,0,0,1,1,1,1,1,0,0,1,1,0,0,0,0,0,0,1,1,1,1,1,1,1],
			[1,1,1,1,1,1,1,1,1,1,1,1,1,1,0,0,0,1,0,24,0,0,0,0,0,1,1,1,1,1,1,1],
			[1,1,1,1,1,1,1,1,1,1,1,1,1,1,0,0,0,0,0,0,1,0,0,0,0,1,1,1,1,1,1,1],
			[1,1,1,1,1,1,1,1,1,1,1,1,1,1,1,1,1,1,1,1,1,8,8,8,8,1,1,1,1,1,1,1],
			[1,1,1,1,1,1,1,1,1,1,1,1,1,1,1,1,1,1,1,1,1,1,1,1,1,1,1,1,1,1,1,1]
		],
		[
			[1,1,1,1,1,1,1,1,1,1,1,1,1,1,1,1,1,1,1,1,1,1,1,1,1,1,1,1,1,1,1,1],
			[1,1,1,1,1,1,1,1,1,1,1,1,1,1,1,1,1,1,1,1,1,1,1,1,1,1,1,1,1,1,1,1],
			[1,1,1,1,1,1,1,1,1,1,1,1,1,1,1,1,1,1,1,1,1,1,1,1,1,1,1,1,1,1,1,1],
			[1,1,1,1,1,1,1,1,1,1,1,1,1,1,1,1,1,1,1,1,1,1,1,1,1,1,1,1,1,1,1,1],
			[1,1,1,1,1,1,1,1,1,1,1,1,1,1,1,1,1,1,1,1,1,1,1,1,1,1,1,1,1,1,1,1],
			[1,1,1,1,1,1,1,1,1,1,1,1,1,1,1,1,1,1,1,1,1,1,1,1,1,1,1,1,1,1,1,1],
			[1,1,1,1,1,1,1,1,1,1,1,1,1,1,1,1,1,1,1,1,1,1,1,1,1,1,1,1,1,1,1,1],
			[1,1,1,1,1,1,1,1,1,1,1,1,0,0,0,0,1,1,0,0,0,0,1,1,0,0,0,0,1,1,1,1],
			[1,1,1,1,1,1,1,1,1,1,1,0,0,1,0,0,1,0,0,1,0,0,1,0,0,1,0,0,1,1,1,1],
			[1,1,1,1,1,1,1,1,1,1,0,0,1,1,0,0,0,0,1,1,0,0,0,0,1,1,0,0,1,1,1,1],
			[1,1,1,1,1,1,1,1,1,1,1,1,1,1,1,1,1,1,1,1,1,1,1,1,1,1,1,1,1,1,1,1],
			[1,1,1,1,1,1,1,1,1,1,1,1,1,1,1,1,1,1,1,1,1,20,20,20,20,1,1,0,1,1,1,1],
			[1,1,1,1,1,1,1,1,1,1,1,1,1,1,1,1,1,1,1,1,1,0,0,0,0,1,1,1,1,1,1,1],
			[1,1,1,1,1,1,1,0,1,1,1,1,1,1,1,1,1,0,0,1,1,0,0,0,0,1,1,1,1,1,1,1],
			[1,1,1,1,1,1,0,1,1,1,1,1,3,1,1,1,0,0,0,1,1,0,0,0,0,1,1,1,1,1,1,1],
			[1,1,1,1,1,0,1,0,0,0,0,0,1,1,1,1,0,0,1,1,1,0,0,0,0,1,1,1,1,1,1,1],
			[1,1,1,1,0,1,0,1,1,1,1,0,1,1,1,1,1,1,1,1,1,0,0,0,0,1,1,1,1,1,1,1],
			[1,1,1,0,1,0,1,0,0,0,1,0,1,1,1,1,1,1,1,1,1,0,0,0,0,1,1,1,1,1,1,1],
			[1,1,0,1,0,3,0,1,1,0,1,0,1,1,1,1,1,1,1,1,1,0,0,0,0,1,1,1,1,1,1,1],
			[1,1,0,1,0,1,0,0,3,0,1,0,1,1,1,1,1,1,1,1,1,0,0,0,0,1,1,1,1,1,1,1],
			[1,1,0,1,0,1,1,0,1,0,1,0,1,1,1,1,1,1,1,1,1,0,0,0,0,1,1,1,1,1,1,1],
			[1,1,0,1,0,0,0,1,0,1,0,1,1,1,1,1,1,1,1,1,1,0,0,0,0,1,1,1,1,1,1,1],
			[1,1,0,1,1,1,1,0,1,0,1,1,1,1,1,1,1,1,1,1,1,0,0,0,0,1,1,1,1,1,1,1],
			[1,1,0,0,0,0,0,1,0,1,1,1,1,1,1,1,1,1,1,1,1,0,0,0,0,1,1,1,1,1,1,1],
			[1,3,1,1,1,1,1,0,1,1,1,1,1,1,1,1,1,1,1,1,1,0,0,0,0,1,1,1,1,1,1,1],
			[1,1,1,1,1,1,0,1,1,2,0,0,1,1,1,1,1,1,1,1,1,0,0,0,0,1,1,1,1,1,1,1],
			[1,1,1,1,1,1,1,1,0,0,0,1,1,1,1,1,1,1,1,1,1,0,0,0,0,1,1,1,1,1,1,1],
			[1,1,1,1,1,1,1,0,0,0,1,1,1,1,1,0,0,1,1,1,1,0,0,0,0,1,1,1,1,1,1,1],
			[1,1,1,1,1,1,1,1,1,1,1,1,1,1,0,0,0,1,1,1,1,0,0,0,0,1,1,1,1,1,1,1],
			[1,1,1,1,1,1,1,1,1,1,1,1,1,1,0,0,1,1,1,1,1,0,0,0,0,1,1,1,1,1,1,1],
			[1,1,1,1,1,1,1,1,1,1,1,1,1,1,1,1,1,1,1,1,1,8,8,8,8,1,1,1,1,1,1,1],
			[1,1,1,1,1,1,1,1,1,1,1,1,1,1,1,1,1,1,1,1,1,1,1,1,1,1,1,1,1,1,1,1]
		]
	],

	"player": [
		{"x":17,"y":14,"hp":100}
	],

	"enemy": [
		{"kind":"koro","x":11,"y":15,"mapIndex":1},
		{"kind":"koro","x":2,"y":23,"mapIndex":1},
		{"kind":"koro","x":9,"y":20,"mapIndex":1},
		{"kind":"koro","x":4,"y":18,"mapIndex":1},
		{"kind":"bone","x":14,"y":7,"mapIndex":1},
		{"kind":"bone","x":20,"y":7,"mapIndex":1},
		{"kind":"bone","x":26,"y":7,"mapIndex":1},
		{"kind":"armo","x":22,"y":16,"mapIndex":1},
		{"kind":"armo","x":22,"y":22,"mapIndex":1},
		{"kind":"armo","x":22,"y":28,"mapIndex":1}
	],

	"item": [
		{"type":"star","x":15,"y":28},
		{"type":"coin","x":14,"y":20},
		{"type":"coin","x":9,"y":26},
		{"type":"coin","x":6,"y":25},
		{"type":"coin","x":11,"y":20},
		{"type":"coin","x":7,"y":15},
		{"type":"coin","x":4,"y":21},
		{"type":"coin","x":6,"y":19},
		{"type":"coin","x":9,"y":17},
		{"type":"coin","x":6,"y":23},
		{"type":"coin","x":2,"y":18},
		{"type":"coin","x":5,"y":13},
		{"type":"coin","x":11,"y":13},
		{"type":"coin","x":12,"y":11},
		{"type":"coin","x":6,"y":11},
		{"type":"coin","x":7,"y":9},
		{"type":"coin","x":12,"y":8},
		{"type":"coin","x":15,"y":8},
		{"type":"coin","x":18,"y":8},
		{"type":"coin","x":21,"y":8},
		{"type":"coin","x":24,"y":8},
		{"type":"coin","x":27,"y":8},
		{"type":"coin","x":30,"y":9},
		{"type":"coin","x":27,"y":11},
		{"type":"coin","x":23,"y":13},
		{"type":"coin","x":22,"y":15},
		{"type":"coin","x":23,"y":16},
		{"type":"coin","x":22,"y":18},
		{"type":"coin","x":23,"y":19},
		{"type":"coin","x":22,"y":21},
		{"type":"coin","x":23,"y":22},
		{"type":"coin","x":22,"y":24},
		{"type":"coin","x":23,"y":25},
		{"type":"coin","x":22,"y":27},
		{"type":"coin","x":23,"y":28},
		{"type":"coin","x":15,"y":27},
		{"type":"coin","x":15,"y":29},
		{"type":"coin","x":14,"y":29},
		{"type":"coin","x":14,"y":28},
		{"type":"coin","x":16,"y":27},
		{"type":"coin","x":16,"y":28}
	]
}