{
	"name": "test stage",
	"icon": 16,
	"mark": 16,
	"wall1": 21,
	"wall2": 22,
	"bgmId": 3,

	"health": 9,
	"gravityPower": 0.1,
	"openStage": 17,
	"openStory": -1,
	"openPuppet": -1,

	"map": [
		[
			[1,1,1,1,1,1,1,1,1,1,1,1,1,1,1,1,1,1,1,1,1,1],
			[1,1,1,1,1,1,1,1,1,1,1,1,1,1,1,1,2,1,1,1,1,1],
			[1,1,1,1,1,1,1,1,1,1,1,1,1,1,0,0,0,0,1,0,1,1],
			[1,1,1,1,1,1,1,1,1,1,1,1,1,0,0,0,0,0,0,0,1,1],
			[1,1,1,1,1,1,1,1,1,1,1,1,1,0,0,0,0,0,0,0,1,1],
			[1,1,1,1,1,1,1,1,1,1,1,1,1,0,1,0,1,0,0,0,1,1],
			[1,1,1,1,1,1,1,1,1,1,1,1,1,1,0,1,1,1,1,0,1,1],
			[1,1,1,1,1,1,1,1,1,1,1,1,1,0,0,0,0,0,1,0,1,1],
			[1,1,1,1,1,1,1,1,1,1,1,1,1,1,1,1,0,1,1,0,1,1],
			[1,1,1,1,1,1,1,1,0,0,0,0,0,1,0,0,1,1,0,1,1,1],
			[1,1,1,1,1,1,1,0,1,1,1,1,1,0,0,0,1,0,1,1,1,1],
			[1,1,1,1,1,1,0,1,1,1,0,0,1,0,0,1,0,1,1,1,1,1],
			[1,1,1,1,1,0,1,0,0,0,0,0,1,1,1,0,1,1,1,1,1,1],
			[1,1,1,1,0,0,1,0,1,0,0,1,0,0,1,1,0,1,0,0,0,1],
			[1,1,1,0,0,0,1,0,1,1,1,0,0,0,1,0,0,1,0,0,0,1],
			[1,1,0,0,0,1,1,0,1,0,1,0,0,1,0,1,0,0,0,0,1,1],
			[1,1,1,0,0,0,0,0,1,0,1,1,0,0,1,1,0,0,0,2,1,1],
			[1,1,0,0,0,1,1,1,1,0,1,1,0,1,0,0,0,0,1,1,1,1],
			[1,1,0,0,0,0,1,1,1,0,1,1,1,0,0,0,1,1,1,1,1,1],
			[1,2,0,0,0,1,1,1,1,0,0,0,0,0,0,0,1,1,1,1,1,1],
			[1,1,0,0,1,1,1,1,1,1,1,1,1,1,1,1,1,1,1,1,1,1],
			[1,1,1,1,1,1,1,1,1,1,1,1,1,1,1,1,1,1,1,1,1,1]
		],
		[
			[1,1,1,1,1,1,1,1,1,1,1,1,1,1,1,1,1,1,1,1,1,1],
			[1,1,1,1,1,1,1,1,1,1,1,1,1,1,1,1,2,1,1,1,1,1],
			[1,1,1,1,1,1,1,1,1,1,1,1,1,1,0,0,0,0,1,0,1,1],
			[1,1,1,1,1,1,1,1,1,1,1,1,1,0,0,0,0,0,0,0,1,1],
			[1,1,1,1,1,1,1,1,1,1,1,1,1,0,0,0,0,0,0,0,1,1],
			[1,1,1,1,1,1,1,1,1,1,1,1,1,0,1,1,1,0,0,0,1,1],
			[1,1,1,1,1,1,1,1,1,1,1,1,1,1,0,1,1,1,1,1,1,1],
			[1,1,1,1,1,1,1,1,1,1,1,1,1,0,0,0,0,0,1,0,1,1],
			[1,1,1,1,1,1,1,1,1,1,1,1,1,1,1,1,0,1,1,0,1,1],
			[1,1,1,1,1,1,1,1,0,0,0,0,0,1,0,0,1,1,0,1,1,1],
			[1,1,1,1,1,1,1,0,1,1,1,1,1,0,0,0,1,0,1,1,1,1],
			[1,1,1,1,1,1,1,1,1,1,0,0,1,0,0,1,0,1,1,1,1,1],
			[1,1,1,1,1,0,1,0,0,0,0,0,1,1,1,0,1,1,1,1,1,1],
			[1,1,1,1,0,0,1,0,1,0,0,1,0,0,1,1,0,1,0,0,0,1],
			[1,1,1,0,0,0,1,0,1,1,1,0,0,0,1,0,0,1,0,0,0,1],
			[1,1,0,0,0,1,1,0,1,0,1,0,0,1,0,1,1,0,0,0,1,1],
			[1,1,1,0,0,1,0,0,1,0,1,1,0,0,1,1,0,0,0,2,1,1],
			[1,1,0,0,0,1,1,1,1,0,1,1,0,1,0,0,0,0,1,1,1,1],
			[1,1,0,0,0,0,1,1,1,0,1,1,1,0,0,0,1,1,1,1,1,1],
			[1,2,0,0,0,1,1,1,1,0,0,1,0,0,0,0,1,1,1,1,1,1],
			[1,1,0,0,1,1,1,1,1,1,1,1,1,1,1,1,1,1,1,1,1,1],
			[1,1,1,1,1,1,1,1,1,1,1,1,1,1,1,1,1,1,1,1,1,1]
		]
	],

	"player": [
		{"x":12,"y":9,"hp":100},
		{"x":9,"y":15,"hp":100},
		{"x":15,"y":12,"hp":100}
	],

	"enemy": [
		{"kind":"koro","x":3,"y":17,"mapIndex":1},
		{"kind":"koro","x":17,"y":16,"mapIndex":1},
		{"kind":"koro","x":16,"y":3,"mapIndex":1},
		{"kind":"koro","x":3,"y":19,"mapIndex":1},
		{"kind":"koro","x":4,"y":14,"mapIndex":1},
		{"kind":"koro","x":14,"y":3,"mapIndex":1},
		{"kind":"koro","x":18,"y":4,"mapIndex":1},
		{"kind":"koro","x":14,"y":18,"mapIndex":1},
		{"kind":"koro","x":19,"y":14,"mapIndex":1}
	],

	"item": [
		{"type":"star","x":10,"y":12},
		{"type":"star","x":12,"y":14},
		{"type":"star","x":14,"y":10},
		{"type":"coin","x":9,"y":12},
		{"type":"coin","x":9,"y":13},
		{"type":"coin","x":10,"y":13},
		{"type":"coin","x":11,"y":12},
		{"type":"coin","x":11,"y":11},
		{"type":"coin","x":10,"y":11},
		{"type":"coin","x":14,"y":9},
		{"type":"coin","x":13,"y":10},
		{"type":"coin","x":13,"y":11},
		{"type":"coin","x":14,"y":11},
		{"type":"coin","x":15,"y":10},
		{"type":"coin","x":15,"y":9},
		{"type":"coin","x":13,"y":13},
		{"type":"coin","x":12,"y":13},
		{"type":"coin","x":11,"y":14},
		{"type":"coin","x":11,"y":15},
		{"type":"coin","x":12,"y":15},
		{"type":"coin","x":13,"y":14}
	]
}